Census Tract,CE01totcounts,CE02totcounts,CE03totcounts,C000totcounts,ct,CE01Percent,CE02Percent,CE03Percent,TractLabel
000100,3124,3823,7025,13972,000100,0.22359003721729173,0.273618665903235,0.5027912968794732,6
000101,553,764,655,1972,000101,0.2804259634888438,0.38742393509127787,0.3321501014198783,5
000103,622,926,844,2392,000103,0.2600334448160535,0.387123745819398,0.3528428093645485,5
000104,28,31,25,84,000104,0.3333333333333333,0.36904761904761907,0.2976190476190476,1
000110,377,546,308,1231,000110,0.3062550771730301,0.4435418359057677,0.2502030869212023,1
000200,4175,5455,4380,14010,000200,0.29800142755174874,0.38936473947180583,0.31263383297644537,5
000201,1010,1354,1449,3813,000201,0.2648832939942303,0.35510097036454236,0.38001573564122737,5
000202,1052,1426,2057,4535,000202,0.23197353914002206,0.31444321940463066,0.4535832414553473,5
000203,253,336,638,1227,000203,0.20619396903015486,0.27383863080684595,0.5199674001629991,6
000300,3245,4238,4630,12113,000300,0.2678939981837695,0.34987203830595226,0.3822339635102782,5
000301,286,325,1488,2099,000301,0.1362553596950929,0.15483563601715103,0.708909004287756,6
000400,2454,3567,3457,9478,000400,0.25891538299219247,0.3763452205106563,0.3647393964971513,5
000401,934,1173,1823,3930,000401,0.2376590330788804,0.29847328244274807,0.4638676844783715,6
000402,1221,1668,2326,5215,000402,0.23413231064237774,0.31984659635666346,0.44602109300095877,5
000403,501,595,1000,2096,000403,0.2390267175572519,0.2838740458015267,0.4770992366412214,6
000404,210,159,239,608,000404,0.34539473684210525,0.26151315789473684,0.3930921052631579,2
000500,1930,2368,2845,7143,000500,0.27019459610807783,0.33151336973260537,0.3982920341593168,5
000501,1321,1553,2266,5140,000501,0.25700389105058363,0.30214007782101165,0.44085603112840466,5
000502,1019,1105,2014,4138,000502,0.24625422909618172,0.26703721604639924,0.48670855485741904,6
000600,5615,7000,7538,20153,000600,0.27861856795514317,0.3473428273706148,0.37403860467424205,5
000700,4825,5838,11222,21885,000700,0.22047064199223212,0.26675805346127485,0.512771304546493,6
000701,304,433,866,1603,000701,0.18964441671865254,0.27011852776044915,0.5402370555208983,6
000702,417,541,1008,1966,000702,0.2121057985757884,0.27517802644964395,0.5127161749745677,6
000800,3911,4620,4857,13388,000800,0.29212727815954587,0.3450851508813863,0.36278757095906783,5
000801,478,707,1450,2635,000801,0.18140417457305502,0.2683111954459203,0.5502846299810247,6
000802,250,303,549,1102,000802,0.22686025408348456,0.2749546279491833,0.4981851179673321,6
000803,455,623,1071,2149,000803,0.21172638436482086,0.2899022801302932,0.498371335504886,6
000900,3159,3854,6956,13969,000900,0.2261436036938936,0.275896628248264,0.49795976805784237,6
001000,3792,4889,4416,13097,001000,0.2895319538825685,0.37329159349469343,0.33717645262273804,5
001001,128,182,566,876,001001,0.1461187214611872,0.20776255707762556,0.6461187214611872,6
001002,688,841,686,2215,001002,0.31060948081264106,0.3796839729119639,0.309706546275395,3
001100,3031,3984,4602,11617,001100,0.26091073426874406,0.34294568305070156,0.3961435826805544,5
001101,319,463,436,1218,001101,0.2619047619047619,0.38013136288998356,0.3579638752052545,5
001102,512,730,824,2066,001102,0.24782187802516942,0.35333978702807356,0.398838334946757,5
001200,2051,2670,3403,8124,001200,0.25246184145741013,0.32865583456425407,0.4188823239783358,5
001300,2255,2721,5655,10631,001300,0.21211551124071112,0.25594958141284924,0.5319349073464397,6
001301,358,480,862,1700,001301,0.21058823529411766,0.2823529411764706,0.5070588235294118,6
001302,370,581,668,1619,001302,0.2285361334156887,0.35886349598517603,0.4126003705991353,5
001303,634,809,906,2349,001303,0.26990208599404003,0.3444018731375053,0.38569604086845466,5
001400,2300,3107,3371,8778,001400,0.26201868307131465,0.35395306447938024,0.3840282524493051,5
001401,608,747,1948,3303,001401,0.18407508325764457,0.22615803814713897,0.5897668785952165,6
001402,1001,1188,1388,3577,001402,0.27984344422700586,0.33212188985183116,0.388034665921163,5
001403,263,420,699,1382,001403,0.19030390738060782,0.30390738060781475,0.5057887120115774,5
001500,3321,4244,6207,13772,001500,0.2411414464130119,0.3081614870752251,0.450697066511763,5
001501,455,480,2261,3196,001501,0.14236545682102628,0.15018773466833543,0.7074468085106383,6
001502,723,899,4102,5724,001502,0.12631027253668764,0.15705800139762405,0.7166317260656884,6
001503,229,342,682,1253,001503,0.1827613727055068,0.27294493216280924,0.5442936951316839,6
001504,425,513,1105,2043,001504,0.20802741067058247,0.2511013215859031,0.5408712677435145,6
001505,165,310,566,1041,001505,0.1585014409221902,0.297790585975024,0.5437079731027857,6
001600,4995,6332,7524,18851,001600,0.2649726804944035,0.33589729987799055,0.39913001962760597,5
001700,2558,3564,4781,10903,001700,0.23461432633220214,0.32688250940108227,0.4385031642667156,5
001701,258,384,247,889,001701,0.29021372328458944,0.43194600674915634,0.2778402699662542,4
001702,293,481,407,1181,001702,0.2480948348856901,0.4072819644369179,0.34462320067739205,5
001800,3950,5289,5684,14923,001800,0.26469208604168065,0.35441935267707564,0.3808885612812437,5
001801,765,825,1800,3390,001801,0.22566371681415928,0.24336283185840707,0.5309734513274337,6
001802,437,571,863,1871,001802,0.2335649385355425,0.30518439337252806,0.46125066809192944,5
001900,2701,3767,4957,11425,001900,0.2364113785557987,0.32971553610503285,0.43387308533916846,5
001901,264,354,693,1311,001901,0.20137299771167047,0.2700228832951945,0.528604118993135,6
001902,302,397,768,1467,001902,0.2058623040218132,0.27062031356509886,0.523517382413088,6
002000,4422,5953,6224,16599,002000,0.2664015904572565,0.3586360624133984,0.3749623471293451,5
002001,273,356,676,1305,002001,0.20919540229885059,0.2727969348659004,0.518007662835249,6
002002,308,372,784,1464,002002,0.2103825136612022,0.2540983606557377,0.5355191256830601,6
002100,2709,3562,7778,14049,002100,0.19282511210762332,0.25354117730799347,0.5536337105843833,6
002101,691,845,1238,2774,002101,0.249098774333093,0.3046142754145638,0.44628695025234316,5
002103,291,311,815,1417,002103,0.205363443895554,0.21947776993648554,0.5751587861679605,6
002104,447,573,1315,2335,002104,0.19143468950749465,0.24539614561027837,0.563169164882227,6
002105,173,200,445,818,002105,0.2114914425427873,0.24449877750611246,0.5440097799511002,6
002106,254,372,616,1242,002106,0.20450885668276972,0.2995169082125604,0.49597423510466987,6
002107,159,224,475,858,002107,0.1853146853146853,0.26107226107226106,0.5536130536130536,6
002200,2190,3040,3042,8272,002200,0.2647485493230174,0.36750483558994196,0.3677466150870406,5
002201,944,1226,2023,4193,002201,0.22513713331743382,0.29239208204149775,0.48247078464106846,6
002202,645,728,1878,3251,002202,0.1984004921562596,0.22393109812365425,0.5776684097200862,6
002203,154,207,417,778,002203,0.19794344473007713,0.2660668380462725,0.5359897172236504,6
002204,393,408,1072,1873,002204,0.20982381206620396,0.21783235451147892,0.5723438334223171,6
002300,3586,4747,4189,12522,002300,0.2863759782782303,0.379092796677847,0.3345312250439227,5
002400,1936,2770,1833,6539,002400,0.29606973543355253,0.4236121731151552,0.2803180914512923,4
002401,168,226,427,821,002401,0.2046285018270402,0.27527405602923266,0.5200974421437271,6
002402,292,335,864,1491,002402,0.19584171696847752,0.22468142186452045,0.579476861167002,6
002403,527,662,1264,2453,002403,0.2148389726865063,0.2698736241337138,0.5152874031797798,6
002404,272,376,629,1277,002404,0.21299921691464369,0.29444009397024273,0.4925606891151135,6
002405,274,375,685,1334,002405,0.20539730134932535,0.2811094452773613,0.5134932533733133,6
002500,2103,2886,1843,6832,002500,0.3078161592505855,0.422423887587822,0.2697599531615925,1
002502,302,325,206,833,002502,0.3625450180072029,0.39015606242497,0.24729891956782712,1
002600,1226,1778,1652,4656,002600,0.26331615120274915,0.38187285223367695,0.3548109965635739,5
002601,424,596,808,1828,002601,0.23194748358862144,0.32603938730853393,0.4420131291028446,5
002602,529,541,1210,2280,002602,0.23201754385964912,0.23728070175438595,0.5307017543859649,6
002700,1137,1507,1596,4240,002700,0.2681603773584906,0.3554245283018868,0.37641509433962267,5
002701,367,481,218,1066,002701,0.3442776735459662,0.45121951219512196,0.2045028142589118,1
002702,665,915,423,2003,002702,0.3320019970044933,0.45681477783325014,0.21118322516225663,1
002800,2037,2788,3703,8528,002800,0.23886022514071295,0.3269230769230769,0.43421669793621015,5
002900,2489,3072,3969,9530,002900,0.26117523609653726,0.3223504721930745,0.41647429171038824,5
002901,733,1003,859,2595,002901,0.28246628131021195,0.38651252408477843,0.3310211946050096,5
003000,1524,1991,1722,5237,003000,0.29100630131754823,0.3801794920756158,0.32881420660683597,5
003001,494,540,1556,2590,003001,0.19073359073359072,0.2084942084942085,0.6007722007722007,6
003002,373,385,1013,1771,003002,0.2106154714850367,0.21739130434782608,0.5719932241671372,6
003100,1827,2431,3554,7812,003100,0.23387096774193547,0.3111879160266257,0.4549411162314388,5
003200,1643,1991,3829,7463,003200,0.22015275358434946,0.26678279512260483,0.5130644512930457,6
003300,2090,2866,5896,10852,003300,0.1925912274235164,0.26409878363435313,0.5433099889421305,6
003301,433,476,252,1161,003301,0.37295434969853575,0.4099913867355728,0.21705426356589147,1
003302,412,404,153,969,003302,0.42518059855521156,0.4169246646026832,0.15789473684210525,1
003400,2494,2968,5006,10468,003400,0.23824990447076805,0.28353076041268627,0.4782193351165457,6
003500,1827,2149,1965,5941,003500,0.3075239858609662,0.3617236155529372,0.3307523985860966,3
003600,1914,2683,3586,8183,003600,0.23389954784308933,0.32787486251985826,0.43822558963705244,5
003601,727,842,1041,2610,003601,0.278544061302682,0.3226053639846743,0.3988505747126437,5
003602,566,652,1211,2429,003602,0.23301770275833678,0.268423219431865,0.49855907780979825,6
003700,1799,2314,3412,7525,003700,0.23906976744186045,0.30750830564784054,0.453421926910299,5
003800,2401,2809,5184,10394,003800,0.23099865306907832,0.2702520685010583,0.4987492784298634,6
003802,136,79,60,275,003802,0.49454545454545457,0.2872727272727273,0.21818181818181817,0
003805,652,906,870,2428,003805,0.2685337726523888,0.3731466227347611,0.35831960461285006,5
003900,2611,3137,5498,11246,003900,0.232171438733772,0.2789436243997866,0.4888849368664414,6
003901,138,198,72,408,003901,0.3382352941176471,0.4852941176470588,0.17647058823529413,1
004000,3265,3932,6149,13346,004000,0.24464258953993706,0.29462011089465007,0.46073729956541287,6
004001,886,1119,895,2900,004001,0.30551724137931036,0.3858620689655172,0.3086206896551724,3
004002,121,199,189,509,004002,0.23772102161100198,0.39096267190569745,0.3713163064833006,5
004100,2808,3419,4758,10985,004100,0.2556213017751479,0.31124260355029587,0.4331360946745562,5
004200,2329,3153,4210,9692,004200,0.24030127940569543,0.3253198514238547,0.4343788691704499,5
004300,2315,3031,4587,9933,004300,0.23306151213127957,0.3051444679351656,0.46179401993355484,5
004301,108,101,45,254,004301,0.4251968503937008,0.39763779527559057,0.17716535433070865,1
004302,308,253,235,796,004302,0.3869346733668342,0.3178391959798995,0.2952261306532663,1
004400,2300,2606,8143,13049,004400,0.1762587171430761,0.1997087899455897,0.6240324929113342,6
004401,893,1146,810,2849,004401,0.31344331344331344,0.40224640224640223,0.2843102843102843,1
004402,381,404,104,889,004402,0.42857142857142855,0.4544431946006749,0.11698537682789652,1
004500,2029,2170,4550,8749,004500,0.23191221853926164,0.24802834609669677,0.5200594353640416,6
004600,1077,1244,2164,4485,004600,0.24013377926421406,0.2773690078037904,0.48249721293199554,6
004601,443,466,513,1422,004601,0.31153305203938114,0.32770745428973275,0.36075949367088606,3
004602,342,335,143,820,004602,0.4170731707317073,0.40853658536585363,0.174390243902439,1
004700,1993,2466,4272,8731,004700,0.22826709426182568,0.28244187378307184,0.4892910319551025,6
004701,413,473,283,1169,004701,0.3532934131736527,0.40461933276304535,0.24208725406330198,1
004702,286,399,176,861,004702,0.3321718931475029,0.4634146341463415,0.20441347270615565,1
004800,2311,2646,5782,10739,004800,0.21519694571189124,0.24639165657882484,0.5384113977092839,6
004900,1942,2186,4705,8833,004900,0.21985735310766444,0.24748103702026492,0.5326616098720707,6
005000,1924,2203,4957,9084,005000,0.21180096873623955,0.24251431087626596,0.5456847203874945,6
005001,709,999,1425,3133,005001,0.22630067028407277,0.31886370890520266,0.45483562081072454,5
005002,910,1195,1831,3936,005002,0.23119918699186992,0.30360772357723576,0.4651930894308943,5
005100,2594,3309,3635,9538,005100,0.2719647724889914,0.3469280771650241,0.38110715034598447,5
005200,1731,1921,3754,7406,005200,0.23372940858763164,0.25938428301377264,0.5068863083985957,6
005201,563,568,1168,2299,005201,0.24488908220965638,0.24706394084384514,0.5080469769464985,6
005202,466,596,1102,2164,005202,0.21534195933456562,0.2754158964879852,0.5092421441774492,6
005300,2080,2459,3573,8112,005300,0.2564102564102564,0.3031311637080868,0.4404585798816568,5
005400,2908,3746,6241,12895,005400,0.22551376502520357,0.29050019387359444,0.483986041101202,6
005500,1794,1929,2256,5979,005500,0.3000501756146513,0.32262920220772706,0.3773206221776217,3
005501,240,281,1444,1965,005501,0.12213740458015267,0.1430025445292621,0.7348600508905853,6
005502,228,187,961,1376,005502,0.16569767441860464,0.13590116279069767,0.6984011627906976,6
005600,1461,1797,2226,5484,005600,0.26641137855579866,0.3276805251641138,0.4059080962800875,5
005601,443,491,1261,2195,005601,0.20182232346241458,0.22369020501138953,0.574487471526196,6
005602,277,304,675,1256,005602,0.22054140127388536,0.24203821656050956,0.5374203821656051,6
005700,1387,1656,2438,5481,005700,0.25305601167670133,0.3021346469622332,0.4448093413610655,5
005701,556,603,1619,2778,005701,0.20014398848092152,0.21706263498920086,0.5827933765298776,6
005702,292,320,765,1377,005702,0.2120551924473493,0.23238925199709515,0.5555555555555556,6
005800,2192,2726,4968,9886,005800,0.22172769573133724,0.27574347562209184,0.5025288286465709,6
005801,412,587,316,1315,005801,0.3133079847908745,0.4463878326996198,0.2403041825095057,1
005802,617,723,332,1672,005802,0.36901913875598086,0.43241626794258375,0.19856459330143542,1
005900,2196,2307,4306,8809,005900,0.24929049835395617,0.2618912475876944,0.4888182540583494,6
005901,449,590,908,1947,005901,0.23061119671289163,0.30303030303030304,0.46635850025680536,5
005902,826,1141,1881,3848,005902,0.21465696465696466,0.2965176715176715,0.48882536382536385,6
006000,2035,2632,4514,9181,006000,0.22165341466071234,0.2866790110009803,0.4916675743383074,6
006100,2334,2985,5260,10579,006100,0.2206257680310048,0.28216277530957556,0.4972114566594196,6
006101,485,524,297,1306,006101,0.37136294027565087,0.4012251148545176,0.22741194486983154,1
006102,209,262,182,653,006102,0.32006125574272587,0.4012251148545176,0.2787136294027565,1
006103,332,456,477,1265,006103,0.2624505928853755,0.36047430830039523,0.37707509881422924,5
006200,1906,2660,3777,8343,006200,0.2284549922090375,0.3188301570178593,0.4527148507731032,5
006201,377,523,1040,1940,006201,0.1943298969072165,0.26958762886597937,0.5360824742268041,6
006202,416,616,1060,2092,006202,0.1988527724665392,0.2944550669216061,0.5066921606118547,6
006300,2744,3430,6286,12460,006300,0.2202247191011236,0.2752808988764045,0.5044943820224719,6
006301,543,672,638,1853,006301,0.2930383162439288,0.36265515380464114,0.34430652995143013,5
006302,221,264,535,1020,006302,0.21666666666666667,0.25882352941176473,0.5245098039215687,6
006400,2464,3097,6702,12263,006400,0.20092962570333522,0.25254831607273914,0.5465220582239256,6
006500,2217,2645,5627,10489,006500,0.21136428639527124,0.25216893888835923,0.5364667747163695,6
006501,627,830,1212,2669,006501,0.23491944548520044,0.3109778943424504,0.4541026601723492,5
006502,246,381,705,1332,006502,0.18468468468468469,0.28603603603603606,0.5292792792792793,6
006600,1948,2296,6417,10661,006600,0.18272207110027203,0.2153644123440578,0.6019135165556702,6
006601,277,368,327,972,006601,0.28497942386831276,0.3786008230452675,0.33641975308641975,5
006602,213,236,429,878,006602,0.24259681093394078,0.26879271070615035,0.4886104783599089,6
006700,2575,2898,6497,11970,006700,0.21512113617376774,0.24210526315789474,0.5427736006683375,6
006701,412,530,532,1474,006701,0.27951153324287653,0.35956580732700133,0.36092265943012214,5
006702,326,471,650,1447,006702,0.22529371112646857,0.3255010366275052,0.44920525224602625,5
006800,2186,2758,5214,10158,006800,0.21519984248867888,0.2715101397912975,0.5132900177200236,6
006801,405,452,1519,2376,006801,0.17045454545454544,0.19023569023569023,0.6393097643097643,6
006802,422,491,1488,2401,006802,0.17576009995835068,0.2044981257809246,0.6197417742607247,6
006900,2271,2777,5594,10642,006900,0.21339973689156175,0.26094719037774855,0.5256530727306897,6
006901,430,476,168,1074,006901,0.40037243947858475,0.44320297951582865,0.1564245810055866,1
006902,466,568,357,1391,006902,0.33501078360891445,0.40833932422717467,0.2566498921639109,1
007000,3141,3740,8235,15116,007000,0.2077930669489283,0.2474199523683514,0.5447869806827202,6
007100,2274,2858,6038,11170,007100,0.2035810205908684,0.255863921217547,0.5405550581915846,6
007101,439,478,173,1090,007101,0.40275229357798165,0.43853211009174314,0.15871559633027524,1
007102,356,359,228,943,007102,0.37751855779427357,0.3806998939554613,0.2417815482502651,1
007200,1851,2259,5973,10083,007200,0.1835763165724487,0.2240404641475751,0.5923832192799762,6
007202,192,347,277,816,007202,0.23529411764705882,0.4252450980392157,0.3394607843137255,5
007300,1740,2024,4834,8598,007300,0.20237264480111655,0.23540358222842522,0.5622237729704582,6
007302,1067,1159,1824,4050,007302,0.2634567901234568,0.28617283950617284,0.45037037037037037,6
007303,830,1031,1624,3485,007303,0.2381635581061693,0.2958393113342898,0.4659971305595409,6
007304,654,699,1399,2752,007304,0.2376453488372093,0.2539970930232558,0.5083575581395349,6
007400,1491,2059,3831,7381,007400,0.2020051483538816,0.2789594905839317,0.5190353610621867,6
007401,388,488,1210,2086,007401,0.1860019175455417,0.2339405560882071,0.5800575263662512,6
007402,202,268,811,1281,007402,0.15768930523028885,0.20921155347384857,0.6330991412958626,6
007500,2617,3134,6932,12683,007500,0.20633919419695657,0.24710242056295828,0.5465583852400852,6
007600,2378,3099,4837,10314,007600,0.23056040333527245,0.3004653868528214,0.46897420981190613,5
007700,2735,3213,7400,13348,007700,0.2048996104285286,0.24071021875936469,0.5543901708121067,6
007800,2658,3588,6368,12614,007800,0.21071824956397653,0.2844458538132234,0.5048358966228,6
007801,268,321,501,1090,007801,0.24587155963302754,0.2944954128440367,0.4596330275229358,6
007802,206,217,430,853,007802,0.24150058616647127,0.2543962485345838,0.5041031652989449,6
007900,2103,2759,4017,8879,007900,0.23685099673386642,0.3107331906746255,0.45241581259150804,5
007901,463,510,733,1706,007901,0.27139507620164127,0.2989449003516999,0.4296600234466589,6
007902,838,1037,1290,3165,007902,0.26477093206951025,0.3276461295418641,0.4075829383886256,5
007903,544,619,750,1913,007903,0.2843700993204391,0.323575535807632,0.3920543648719289,5
007904,463,616,789,1868,007904,0.24785867237687367,0.3297644539614561,0.42237687366167026,5
007905,627,782,961,2370,007905,0.2645569620253165,0.329957805907173,0.4054852320675105,5
008000,1493,1961,3582,7036,008000,0.21219442865264354,0.2787094940306993,0.5090960773166572,6
008001,890,930,1148,2968,008001,0.2998652291105121,0.3133423180592992,0.3867924528301887,5
008002,818,931,1173,2922,008002,0.2799452429842574,0.3186173853524983,0.40143737166324434,5
008003,844,935,1035,2814,008003,0.2999289267945984,0.3322672352523099,0.3678038379530917,5
008100,2113,2509,5557,10179,008100,0.20758424206700068,0.24648786717752236,0.545927890755477,6
008101,810,959,1275,3044,008101,0.26609724047306177,0.31504599211563733,0.4188567674113009,5
008102,650,673,1130,2453,008102,0.26498165511618427,0.27435792906644924,0.4606604158173665,6
008200,1708,2223,4392,8323,008200,0.20521446593776282,0.2670911930794185,0.5276943409828186,6
008201,346,468,490,1304,008201,0.26533742331288346,0.3588957055214724,0.37576687116564417,5
008202,468,617,619,1704,008202,0.2746478873239437,0.36208920187793425,0.36326291079812206,5
008300,1647,2168,2550,6365,008300,0.2587588373919874,0.3406127258444619,0.40062843676355064,5
008301,740,1167,1188,3095,008301,0.23909531502423265,0.37705977382875605,0.3838449111470113,5
008302,407,413,1799,2619,008302,0.1554028255059183,0.15769377625047729,0.6869033982436045,6
008400,1567,2058,2292,5917,008400,0.26483015041406116,0.34781139090755453,0.3873584586783843,5
008401,149,157,569,875,008401,0.1702857142857143,0.17942857142857144,0.6502857142857142,6
008403,267,347,1013,1627,008403,0.16410571604179472,0.2132759680393362,0.6226183159188691,6
008404,393,495,1304,2192,008404,0.1792883211678832,0.2258211678832117,0.5948905109489051,6
008500,2413,3231,3156,8800,008500,0.2742045454545455,0.36715909090909093,0.35863636363636364,5
008600,1838,2505,2946,7289,008600,0.2521607902318562,0.3436685416380848,0.404170668130059,5
008601,132,173,1038,1343,008601,0.09828741623231571,0.12881608339538347,0.7728965003723008,6
008602,364,397,1424,2185,008602,0.1665903890160183,0.18169336384439358,0.6517162471395881,6
008603,245,209,1427,1881,008603,0.13024986709197237,0.1111111111111111,0.7586390217969166,6
008700,2425,3321,5918,11664,008700,0.20790466392318244,0.2847222222222222,0.5073731138545954,6
008701,477,694,369,1540,008701,0.30974025974025976,0.45064935064935063,0.2396103896103896,1
008702,223,279,121,623,008702,0.3579454253611557,0.4478330658105939,0.1942215088282504,1
008800,2189,2883,6215,11287,008800,0.1939399308939488,0.25542659696996545,0.5506334721360857,6
008900,1404,1634,3516,6554,008900,0.2142203234665853,0.24931339639914557,0.5364662801342691,6
008901,480,568,1750,2798,008901,0.17155110793423875,0.20300214438884917,0.6254467476769121,6
008902,379,460,1007,1846,008902,0.20530877573131096,0.24918743228602383,0.5455037919826652,6
009000,1630,1914,4925,8469,009000,0.19246664305112765,0.22600070846617074,0.5815326484827016,6
009004,471,419,985,1875,009004,0.2512,0.22346666666666667,0.5253333333333333,6
009006,879,855,1939,3673,009006,0.2393139123332426,0.23277974407841,0.5279063435883474,6
009007,883,687,2084,3654,009007,0.24165298303229338,0.18801313628899835,0.5703338806787083,6
009008,446,375,1033,1854,009008,0.2405609492988134,0.2022653721682848,0.5571736785329018,6
009009,599,521,1326,2446,009009,0.24488961569910056,0.21300081766148815,0.5421095666394112,6
009010,696,584,1481,2761,009010,0.25208257877580587,0.2115175660992394,0.5363998551249547,6
009100,1335,1509,4613,7457,009100,0.17902641813061554,0.20236019847123507,0.6186133833981494,6
009104,562,513,1064,2139,009104,0.262739597942964,0.23983169705469845,0.49742870500233755,6
009106,449,422,728,1599,009106,0.28080050031269543,0.26391494684177613,0.45528455284552843,6
009107,686,718,855,2259,009107,0.30367419212040725,0.3178397521027003,0.3784860557768924,3
009109,491,461,679,1631,009109,0.30104230533415083,0.2826486817903127,0.41630901287553645,2
009110,167,142,220,529,009110,0.31568998109640833,0.2684310018903592,0.4158790170132325,2
009112,300,286,418,1004,009112,0.29880478087649404,0.2848605577689243,0.4163346613545817,6
009113,890,750,1706,3346,009113,0.2659892408846384,0.22414823670053796,0.5098625224148237,6
009114,544,523,1024,2091,009114,0.2601626016260163,0.2501195600191296,0.48971783835485416,6
009115,293,283,479,1055,009115,0.2777251184834123,0.2682464454976303,0.45402843601895737,6
009116,686,678,1033,2397,009116,0.2861910721735503,0.2828535669586984,0.4309553608677514,6
009200,2572,3452,5138,11162,009200,0.2304246550797348,0.30926357283640926,0.46031177208385593,5
009300,1693,2126,4265,8084,009300,0.20942602671944582,0.26298861949529934,0.5275853537852548,6
009301,1033,1132,948,3113,009301,0.3318342434950209,0.36363636363636365,0.30452939286861547,3
009302,682,849,817,2348,009302,0.29045996592844975,0.36158432708688243,0.3479557069846678,5
009400,1999,2220,2762,6981,009400,0.28634866065033665,0.31800601633003867,0.3956453230196247,5
009401,649,711,1265,2625,009401,0.24723809523809523,0.27085714285714285,0.4819047619047619,6
009402,518,546,1174,2238,009402,0.23145665773011617,0.24396782841823056,0.5245755138516532,6
009500,1446,1598,3461,6505,009500,0.22229054573405074,0.24565718677940046,0.5320522674865488,6
009501,654,581,1329,2564,009501,0.2550702028081123,0.2265990639625585,0.5183307332293292,6
009502,848,897,1668,3413,009502,0.2484617638441254,0.26281863463228833,0.4887196015235863,6
009600,2207,2798,4604,9609,009600,0.2296805078572172,0.2911853470704548,0.47913414507232804,6
009601,591,693,1006,2290,009601,0.25807860262008736,0.3026200873362445,0.4393013100436681,5
009602,610,627,908,2145,009602,0.28438228438228436,0.2923076923076923,0.4233100233100233,6
009603,246,307,119,672,009603,0.36607142857142855,0.4568452380952381,0.17708333333333334,1
009604,157,195,48,400,009604,0.3925,0.4875,0.12,1
009700,1164,1462,2920,5546,009700,0.20988099531193652,0.26361341507392716,0.5265055896141363,6
009701,759,805,1654,3218,009701,0.23586078309509012,0.2501553760099441,0.5139838408949658,6
009702,828,1043,1786,3657,009702,0.22641509433962265,0.28520645337708506,0.4883784522832923,6
009703,316,338,1373,2027,009703,0.15589541193882586,0.1667488899851998,0.6773556980759744,6
009800,2314,3058,6212,11584,009800,0.1997582872928177,0.26398480662983426,0.5362569060773481,6
009900,1038,1293,3218,5549,009900,0.18706073166336276,0.23301495765002703,0.5799243106866102,6
010000,1868,2275,3934,8077,010000,0.23127398786678222,0.28166398415253185,0.4870620279806859,6
010001,464,612,600,1676,010001,0.27684964200477324,0.36515513126491644,0.35799522673031026,5
010002,598,741,741,2080,010002,0.2875,0.35625,0.35625,5
010003,578,681,730,1989,010003,0.2905982905982906,0.34238310708898945,0.36701860231271993,5
010100,3350,4298,7207,14855,010100,0.2255132951868058,0.2893301918545944,0.4851565129585998,6
010101,1784,2138,3587,7509,010101,0.23758156878412573,0.28472499667066187,0.4776934345452124,6
010102,1677,2108,2802,6587,010102,0.2545923789281919,0.3200242902687111,0.425383330803097,5
010103,564,830,839,2233,010103,0.25257501119570086,0.3716972682489924,0.3757277205553068,5
010200,5750,6423,10876,23049,010200,0.24946852358019872,0.2786671872966289,0.47186428912317235,6
010201,858,1191,1240,3289,010201,0.2608695652173913,0.3621161447248404,0.3770142900577683,5
010202,1083,1261,1296,3640,010202,0.2975274725274725,0.3464285714285714,0.35604395604395606,5
010300,4023,4692,8470,17185,010300,0.2340995053826011,0.2730288041897003,0.49287169042769857,6
010301,671,771,1220,2662,010301,0.25206611570247933,0.28963185574755823,0.45830202854996244,6
010321,401,364,778,1543,010321,0.25988334413480235,0.23590408295528192,0.5042125729099157,6
010322,458,614,1081,2153,010322,0.2127264282396656,0.2851834649326521,0.5020901068276823,6
010400,4673,5755,7650,18078,010400,0.2584909835158756,0.31834273702843235,0.423166279455692,5
010500,4553,5191,9594,19338,010500,0.23544316889026787,0.26843520529527354,0.49612162581445857,6
010501,885,1120,1691,3696,010501,0.23944805194805194,0.30303030303030304,0.457521645021645,5
010502,854,1131,1875,3860,010502,0.22124352331606217,0.29300518134715026,0.48575129533678757,6
010503,198,248,581,1027,010503,0.19279454722492698,0.24148003894839337,0.5657254138266796,6
010600,3578,4420,6139,14137,010600,0.25309471599349226,0.3126547357996746,0.4342505482068331,5
010601,1242,1443,3683,6368,010601,0.19503768844221106,0.22660175879396985,0.5783605527638191,6
010602,1415,1982,3971,7368,010602,0.19204668838219327,0.2690010857763301,0.5389522258414766,6
010700,2859,3615,5215,11689,010700,0.24458892976302507,0.30926512105398235,0.44614594918299255,5
010701,1280,1501,2669,5450,010701,0.23486238532110093,0.27541284403669725,0.4897247706422018,6
010702,977,1386,2291,4654,010702,0.20992694456381608,0.29780833691448216,0.4922647185217018,6
010703,410,560,506,1476,010703,0.2777777777777778,0.3794037940379404,0.3428184281842818,5
010800,3169,3887,7315,14371,010800,0.2205135342008211,0.27047526268178973,0.5090112031173892,6
010801,1162,1243,2950,5355,010801,0.2169934640522876,0.23211951447245566,0.5508870214752568,6
010802,1177,1141,2690,5008,010802,0.23502396166134185,0.22783546325878595,0.5371405750798722,6
010803,1207,1309,3016,5532,010803,0.21818510484454084,0.2366232827187274,0.5451916124367318,6
010804,1198,1266,2751,5215,010804,0.22972195589645253,0.24276126558005753,0.5275167785234899,6
010805,779,935,1246,2960,010805,0.2631756756756757,0.3158783783783784,0.4209459459459459,5
010807,784,891,993,2668,010807,0.2938530734632684,0.3339580209895052,0.3721889055472264,5
010808,562,722,842,2126,010808,0.264346190028222,0.3396048918156162,0.39604891815616183,5
010809,491,632,859,1982,010809,0.2477295660948537,0.31886982845610495,0.43340060544904135,5
010900,2147,2549,4540,9236,010900,0.23245993936769163,0.2759852750108272,0.49155478562148114,6
010901,2077,2595,3673,8345,010901,0.24889155182744158,0.310964649490713,0.44014379868184544,5
010902,2652,3389,5437,11478,010902,0.23105070569785677,0.29526049834465934,0.47368879595748387,6
010903,517,668,1232,2417,010903,0.2139015308233347,0.27637567232105914,0.5097227968556062,6
011000,3736,4756,9091,17583,011000,0.21247796166751975,0.27048854006711026,0.5170334982653699,6
011001,232,382,329,943,011001,0.24602332979851538,0.4050901378579003,0.3488865323435843,5
011002,362,537,393,1292,011002,0.2801857585139319,0.41563467492260064,0.3041795665634675,5
011011,376,564,861,1801,011011,0.2087729039422543,0.31315935591338145,0.47806774014436426,5
011012,497,692,842,2031,011012,0.2447070408665682,0.34071885770556376,0.41457410142786805,5
011021,418,393,797,1608,011021,0.2599502487562189,0.24440298507462688,0.4956467661691542,6
011022,421,517,693,1631,011022,0.25812385039852853,0.31698344573881054,0.4248927038626609,5
011100,3160,4135,6498,13793,011100,0.22910171826288697,0.2997897484231132,0.4711085333139999,6
011101,2041,2330,5332,9703,011101,0.21034731526332062,0.24013191796351643,0.549520766773163,6
011102,1976,2395,4001,8372,011102,0.2360248447204969,0.28607262302914477,0.47790253225035834,6
011200,5376,6264,9471,21111,011200,0.2546539718630098,0.29671735114395337,0.4486286769930368,6
011201,1599,1946,3359,6904,011201,0.23160486674391656,0.2818655851680185,0.48652954808806487,6
011202,1161,1373,2923,5457,011202,0.21275426058273778,0.2516034451163643,0.5356422943008979,6
011203,415,409,1126,1950,011203,0.2128205128205128,0.20974358974358975,0.5774358974358974,6
011205,721,645,1500,2866,011205,0.2515701325889742,0.22505233775296582,0.5233775296580601,6
011207,597,699,1175,2471,011207,0.2416025900445164,0.282881424524484,0.4755159854309996,6
011208,544,666,1075,2285,011208,0.23807439824945295,0.29146608315098466,0.47045951859956237,6
011231,570,703,1090,2363,011231,0.24121878967414304,0.2975031739314431,0.4612780363944139,6
011232,482,571,980,2033,011232,0.23708804722085589,0.2808657156910969,0.4820462370880472,6
011241,247,296,643,1186,011241,0.20826306913996628,0.24957841483979765,0.5421585160202361,6
011242,754,919,1467,3140,011242,0.24012738853503185,0.2926751592356688,0.46719745222929937,6
011300,3220,3690,6625,13535,011300,0.23790173623937938,0.2726265238271149,0.48947173993350573,6
011301,2053,2247,3930,8230,011301,0.249453219927096,0.27302551640340217,0.4775212636695018,6
011302,1663,1827,3445,6935,011302,0.23979812545061283,0.26344628695025235,0.4967555875991348,6
011303,610,632,1573,2815,011303,0.216696269982238,0.22451154529307282,0.5587921847246892,6
011400,3769,4442,7856,16067,011400,0.23458019543163006,0.27646729320968444,0.4889525113586855,6
011401,1620,1652,3858,7130,011401,0.22720897615708274,0.23169705469845722,0.5410939691444601,6
011402,963,1262,2741,4966,011402,0.19391864679822796,0.25412807088199757,0.5519532823197745,6
011403,592,640,1536,2768,011403,0.2138728323699422,0.23121387283236994,0.5549132947976878,6
011404,419,481,1228,2128,011404,0.19689849624060152,0.22603383458646617,0.5770676691729323,6
011405,475,548,1103,2126,011405,0.22342427093132644,0.257761053621825,0.5188146754468486,6
011500,3203,3604,7571,14378,011500,0.22277089998608987,0.2506607316733899,0.5265683683405202,6
011501,1809,2050,3479,7338,011501,0.24652493867538838,0.2793676751158354,0.47410738620877624,6
011502,1470,1900,1978,5348,011502,0.27486910994764396,0.35527299925205685,0.3698578908002992,5
011503,763,676,1420,2859,011503,0.26687653025533403,0.23644630989856594,0.49667715984610006,6
011504,1736,2115,3115,6966,011504,0.24921045076083836,0.30361757105943155,0.44717197817973015,5
011505,1142,1009,1875,4026,011505,0.2836562344759066,0.25062096373571785,0.46572280178837555,6
011506,476,339,449,1264,011506,0.37658227848101267,0.26819620253164556,0.3552215189873418,2
011600,3291,3926,6268,13485,011600,0.24404894327030033,0.29113830181683353,0.46481275491286617,6
011601,1519,1774,2875,6168,011601,0.24627107652399483,0.28761348897535666,0.4661154345006485,6
011602,888,975,1827,3690,011602,0.24065040650406505,0.26422764227642276,0.4951219512195122,6
011603,762,782,1379,2923,011603,0.2606910708176531,0.2675333561409511,0.47177557304139583,6
011604,338,282,603,1223,011604,0.276369582992641,0.23058053965658218,0.49304987735077677,6
011605,344,287,524,1155,011605,0.29783549783549784,0.24848484848484848,0.4536796536796537,6
011700,3043,3666,7551,14260,011700,0.21339410939691444,0.25708274894810657,0.5295231416549789,6
011701,516,607,1075,2198,011701,0.23475887170154686,0.27616014558689717,0.489080982711556,6
011702,479,508,891,1878,011702,0.25505857294994677,0.27050053248136313,0.4744408945686901,6
011703,971,1032,2247,4250,011703,0.22847058823529412,0.24282352941176472,0.5287058823529411,6
011705,572,622,1265,2459,011705,0.23261488409922731,0.2529483529890199,0.5144367629117528,6
011706,545,468,1211,2224,011706,0.24505395683453238,0.210431654676259,0.5445143884892086,6
011707,817,793,1812,3422,011707,0.23874926943308006,0.23173582700175335,0.5295149035651666,6
011708,409,342,870,1621,011708,0.2523133867982727,0.21098087600246762,0.5367057371992597,6
011800,4793,5465,11748,22006,011800,0.21780423520857947,0.24834136144687813,0.5338544033445424,6
011801,588,585,983,2156,011801,0.2727272727272727,0.27133580705009275,0.4559369202226345,6
011802,328,339,606,1273,011802,0.25765907305577374,0.2663000785545954,0.4760408483896308,6
011900,2742,3379,5245,11366,011900,0.2412458208692592,0.2972901636459616,0.46146401548477917,6
011901,1402,1642,2564,5608,011901,0.25,0.2927960057061341,0.4572039942938659,6
011902,1753,1917,4067,7737,011902,0.22657360734134677,0.24777045366421094,0.5256559389944423,6
011903,295,413,438,1146,011903,0.25741710296684117,0.36038394415357766,0.38219895287958117,5
012000,2839,3188,5915,11942,012000,0.237732373136828,0.26695695863339475,0.49531066822977726,6
012001,610,744,984,2338,012001,0.2609067579127459,0.31822070145423437,0.42087254063301965,5
012002,531,523,883,1937,012002,0.27413526071244193,0.27000516262261226,0.4558595766649458,6
012003,727,736,1254,2717,012003,0.2675745307324255,0.270887007729113,0.46153846153846156,6
012100,3717,3543,7294,14554,012100,0.2553937061976089,0.2434382300398516,0.5011680637625395,6
012101,1761,2053,3458,7272,012101,0.24216171617161716,0.2823157315731573,0.47552255225522555,6
012102,1976,2035,3183,7194,012102,0.27467333889352236,0.28287461773700306,0.4424520433694746,6
012103,968,1107,1263,3338,012103,0.28999400838825645,0.3316357100059916,0.3783702816057519,5
012105,580,461,521,1562,012105,0.3713188220230474,0.29513444302176695,0.33354673495518566,2
012106,388,501,550,1439,012106,0.2696316886726894,0.3481584433634468,0.3822098679638638,5
012200,2582,2909,5811,11302,012200,0.22845514068306494,0.25738807290745,0.514156786409485,6
012201,774,895,1398,3067,012201,0.2523638734920117,0.2918161069448973,0.455820019563091,6
012202,1642,2284,2582,6508,012202,0.25230485556238474,0.35095267363245236,0.3967424708051629,5
012203,311,371,495,1177,012203,0.26423109600679695,0.31520815632965166,0.4205607476635514,5
012204,299,327,394,1020,012204,0.2931372549019608,0.3205882352941177,0.3862745098039216,5
012300,3037,3944,4194,11175,012300,0.27176733780760626,0.3529306487695749,0.37530201342281877,5
012301,1057,1023,2719,4799,012301,0.2202542196290894,0.2131694102938112,0.5665763700770994,6
012303,326,394,1300,2020,012303,0.1613861386138614,0.19504950495049506,0.6435643564356436,6
012304,836,733,2437,4006,012304,0.20868696954568147,0.18297553669495756,0.608337493759361,6
012305,446,386,1080,1912,012305,0.23326359832635984,0.20188284518828453,0.5648535564853556,6
012306,513,371,1413,2297,012306,0.22333478450152372,0.16151501959077058,0.6151501959077057,6
012400,2206,2745,7252,12203,012400,0.18077521920839137,0.22494468573301646,0.5942800950585921,6
012401,1048,1525,1540,4113,012401,0.25480184779965964,0.37077558959397033,0.37442256260637,5
012402,1317,1445,2428,5190,012402,0.253757225433526,0.27842003853564545,0.4678227360308285,6
012500,2802,3628,5656,12086,012500,0.23183849081581995,0.30018202879364553,0.4679794803905345,5
012501,1485,1585,2593,5663,012501,0.26222850079463184,0.27988698569662723,0.45788451350874093,6
012502,1270,1326,3078,5674,012502,0.2238279873105393,0.23369756785336623,0.5424744448360944,6
012503,331,324,1248,1903,012503,0.17393589069889648,0.17025748817656333,0.6558066211245402,6
012600,3789,4260,11550,19599,012600,0.1933261901117404,0.21735802847084035,0.5893157814174192,6
012601,580,735,1067,2382,012601,0.2434928631402183,0.30856423173803527,0.44794290512174645,5
012602,582,858,927,2367,012602,0.2458808618504436,0.36248415716096327,0.3916349809885932,5
012700,3514,3831,8605,15950,012700,0.22031347962382444,0.24018808777429468,0.5394984326018809,6
012701,864,1236,1120,3220,012701,0.2683229813664596,0.3838509316770186,0.34782608695652173,5
012702,583,689,1068,2340,012702,0.24914529914529915,0.29444444444444445,0.4564102564102564,6
012800,3904,4962,8385,17251,012800,0.22630572140745464,0.28763549939133964,0.4860587792012057,6
012801,310,311,286,907,012801,0.34178610804851156,0.3428886438809261,0.3153252480705623,3
012802,599,676,1846,3121,012802,0.1919256648510093,0.21659724447292533,0.5914770906760654,6
012804,375,518,1004,1897,012804,0.19768054823405376,0.2730627306273063,0.52925672113864,6
012805,261,298,743,1302,012805,0.20046082949308755,0.22887864823348694,0.5706605222734255,6
012806,585,646,1395,2626,012806,0.22277227722772278,0.246001523229246,0.5312261995430312,6
012900,2884,3289,6604,12777,012900,0.22571808718791578,0.2574156687798388,0.5168662440322455,6
012901,1610,2031,2522,6163,012901,0.26123641083887716,0.32954729839363944,0.4092162907674834,5
012902,697,768,1539,3004,012902,0.23202396804260986,0.255659121171771,0.5123169107856191,6
013000,3901,4652,8130,16683,013000,0.23383084577114427,0.2788467302043997,0.487322424024456,6
013001,1488,1625,2432,5545,013001,0.2683498647430117,0.29305680793507666,0.43859332732191164,6
013002,2034,2184,4166,8384,013002,0.24260496183206107,0.26049618320610685,0.49689885496183206,6
013003,317,245,772,1334,013003,0.2376311844077961,0.18365817091454273,0.5787106446776612,6
013100,3552,4290,7852,15694,013100,0.2263285331974003,0.27335287370969796,0.5003185930929017,6
013101,1725,2022,2998,6745,013101,0.2557449962935508,0.29977761304670125,0.44447739065974795,6
013102,1644,1507,3756,6907,013102,0.23801940060807877,0.21818445055740554,0.5437961488345157,6
013103,684,666,1986,3336,013103,0.20503597122302158,0.19964028776978418,0.5953237410071942,6
013104,1087,1206,2217,4510,013104,0.241019955654102,0.26740576496674057,0.49157427937915743,6
013200,2693,3281,7911,13885,013200,0.193950306085704,0.236298163485776,0.56975153042852,6
013201,2316,2408,4449,9173,013201,0.2524801046549657,0.26250953886405753,0.4850103564809768,6
013202,1670,1672,3221,6563,013202,0.2544568032911778,0.2547615419777541,0.4907816547310681,6
013203,1216,1319,2424,4959,013203,0.24521072796934865,0.2659810445654366,0.48880822746521474,6
013204,1387,1690,3010,6087,013204,0.22786265812387055,0.2776408739937572,0.4944964678823723,6
013205,583,615,905,2103,013205,0.27722301474084643,0.29243937232524964,0.43033761293390393,6
013206,687,812,1476,2975,013206,0.23092436974789915,0.27294117647058824,0.4961344537815126,6
013300,4546,5180,9795,19521,013300,0.23287741406690232,0.2653552584396291,0.5017673274934685,6
013301,1114,1524,1655,4293,013301,0.2594921965991148,0.3549965059399022,0.385511297460983,5
013302,358,406,467,1231,013302,0.2908204711616572,0.3298131600324939,0.3793663688058489,5
013303,302,411,612,1325,013303,0.22792452830188678,0.31018867924528304,0.4618867924528302,5
013304,1169,1436,2282,4887,013304,0.2392060568856149,0.29384080212809494,0.46695314098629015,6
013400,5370,6243,14105,25718,013400,0.20880317287502917,0.2427482696943775,0.5484485574305934,6
013401,943,1285,1863,4091,013401,0.2305059887558054,0.3141041310193107,0.4553898802248839,5
013402,774,928,1803,3505,013402,0.22082738944365193,0.2647646219686163,0.5144079885877318,6
013500,3571,4126,8482,16179,013500,0.22071821497002286,0.25502194202361084,0.5242598430063663,6
013501,1016,865,1718,3599,013501,0.28230063906640734,0.24034454015004167,0.47735482078355096,6
013502,763,683,1921,3367,013502,0.22661122661122662,0.20285120285120284,0.5705375705375706,6
013503,1261,1471,2655,5387,013503,0.23408204937813254,0.2730647855949508,0.4928531650269167,6
013505,853,1146,1438,3437,013505,0.24818155368053535,0.33343031713703813,0.4183881291824265,5
013506,1821,2120,3728,7669,013506,0.23744947189985657,0.2764376059460164,0.486112922154127,6
013507,1115,1183,2206,4504,013507,0.24755772646536411,0.2626554174067496,0.4897868561278863,6
013508,1181,1308,2901,5390,013508,0.21910946196660483,0.24267161410018553,0.5382189239332097,6
013600,3456,4225,10861,18542,013600,0.18638766044655378,0.22786107216050047,0.5857512673929457,6
013601,1544,1956,2814,6314,013601,0.244535951853025,0.30978777320240736,0.44567627494456763,5
013602,423,560,1090,2073,013602,0.2040520984081042,0.27013989387361315,0.5258080077182827,6
013603,698,771,1249,2718,013603,0.2568064753495217,0.2836644591611479,0.45952906548933037,6
013604,706,729,927,2362,013604,0.2988992379339543,0.3086367485182049,0.39246401354784083,5
013700,2098,2364,6417,10879,013700,0.1928486074087692,0.2172993841345712,0.5898520084566596,6
013701,1813,2337,2576,6726,013701,0.2695509961344038,0.3474576271186441,0.3829913767469521,5
013702,1201,1389,2135,4725,013702,0.2541798941798942,0.293968253968254,0.45185185185185184,6
013703,242,277,515,1034,013703,0.23404255319148937,0.2678916827852998,0.49806576402321084,6
013705,739,948,1720,3407,013705,0.21690636923980042,0.2782506604050484,0.5048429703551511,6
013706,215,226,585,1026,013706,0.20955165692007796,0.2202729044834308,0.5701754385964912,6
013707,669,743,1613,3025,013707,0.22115702479338842,0.2456198347107438,0.5332231404958677,6
013800,5241,6427,14030,25698,013800,0.203945832360495,0.25009728383531793,0.545956883804187,6
013801,958,1144,1755,3857,013801,0.2483795696136894,0.29660357791029296,0.45501685247601764,6
013802,526,662,1303,2491,013802,0.2111601766358892,0.26575672420714574,0.523083099156965,6
013900,3077,3395,8785,15257,013900,0.20167791833256865,0.22252081011994496,0.5758012715474864,6
013901,905,1183,1343,3431,013901,0.2637714951909064,0.344797435150102,0.39143106965899155,5
013902,1259,1647,1892,4798,013902,0.26240100041684034,0.3432680283451438,0.39433097123801586,5
014000,2480,2986,5964,11430,014000,0.2169728783902012,0.26124234470691166,0.5217847769028872,6
014001,1099,1365,1802,4266,014001,0.2576183778715424,0.319971870604782,0.42240975152367555,5
014002,522,800,942,2264,014002,0.23056537102473498,0.35335689045936397,0.4160777385159011,5
014003,609,919,772,2300,014003,0.2647826086956522,0.39956521739130435,0.3356521739130435,5
014004,565,690,708,1963,014004,0.28782475802343355,0.3515028018339277,0.36067244014263883,5
014100,2770,3773,6017,12560,014100,0.22054140127388536,0.3003980891719745,0.47906050955414015,5
014101,1278,1296,2498,5072,014101,0.25197160883280756,0.2555205047318612,0.4925078864353312,6
014102,1800,2012,3401,7213,014102,0.24954942464993762,0.27894080133093024,0.47150977401913213,6
014103,571,666,937,2174,014103,0.2626494940202392,0.3063477460901564,0.4310027598896044,5
014104,435,565,681,1681,014104,0.2587745389649018,0.3361094586555622,0.405116002379536,5
014200,1839,2394,3814,8047,014200,0.2285323723126631,0.29750217472349944,0.47396545296383746,6
014201,1413,1625,3064,6102,014201,0.23156342182890854,0.26630612913798757,0.5021304490331039,6
014202,2403,2711,5029,10143,014202,0.23691215616681455,0.26727792566301883,0.4958099181701666,6
014203,1529,1797,2903,6229,014203,0.24546476159897254,0.2884893241290737,0.46604591427195374,6
014204,927,1070,1652,3649,014204,0.25404220334338173,0.2932310221978624,0.4527267744587558,6
014206,1026,853,2280,4159,014206,0.24669391680692473,0.20509737917768694,0.5482087040153883,6
014207,781,813,1472,3066,014207,0.25472928897586433,0.2651663405088063,0.4801043705153294,6
014208,765,714,1326,2805,014208,0.2727272727272727,0.2545454545454545,0.4727272727272727,6
014209,663,605,1281,2549,014209,0.2601020007846214,0.23734797959984308,0.5025500196155355,6
014300,2482,3315,4204,10001,014300,0.24817518248175183,0.3314668533146685,0.4203579642035796,5
014301,1738,2089,3173,7000,014301,0.24828571428571428,0.29842857142857143,0.4532857142857143,6
014302,2691,2866,5439,10996,014302,0.24472535467442708,0.2606402328119316,0.4946344125136413,6
014400,3938,5087,6528,15553,014400,0.253198739792966,0.3270751623481,0.41972609785893394,5
014401,650,828,2598,4076,014401,0.15947006869479882,0.20314033366045142,0.6373895976447498,6
014402,776,965,3355,5096,014402,0.152276295133438,0.18936420722135008,0.658359497645212,6
014500,2951,3929,6699,13579,014500,0.21732086309742984,0.2893438397525591,0.49333529715001107,6
014501,1927,2211,3771,7909,014501,0.2436464786951574,0.2795549374130737,0.4767985838917689,6
014502,1273,1603,2568,5444,014502,0.23383541513592945,0.29445260837619397,0.47171197648787655,6
014503,834,921,1558,3313,014503,0.2517355870811953,0.27799577422275884,0.4702686386960459,6
014504,853,896,1384,3133,014504,0.2722630067028407,0.2859878710501117,0.44174912224704754,6
014505,670,880,976,2526,014505,0.26524148851939827,0.34837688044338877,0.38638163103721296,5
014600,1892,2168,3479,7539,014600,0.2509616660034487,0.28757129592784186,0.46146703806870937,6
014601,1828,1852,4369,8049,014601,0.22710895763448877,0.2300906944962107,0.5428003478693005,6
014602,1167,1281,4393,6841,014602,0.1705890951615261,0.18725332553720217,0.6421575793012717,6
014603,562,477,1205,2244,014603,0.25044563279857396,0.21256684491978609,0.5369875222816399,6
014604,2047,1976,4758,8781,014604,0.23311695706639335,0.2250313176175834,0.5418517253160232,6
014605,655,727,1809,3191,014605,0.20526480727044813,0.22782826700094014,0.5669069257286117,6
014606,1509,1554,4117,7180,014606,0.21016713091922007,0.21643454038997215,0.5733983286908078,6
014607,1754,1836,4622,8212,014607,0.2135898684851437,0.2235752557233317,0.5628348757915246,6
014608,766,815,1763,3344,014608,0.229066985645933,0.2437200956937799,0.5272129186602871,6
014609,480,641,1312,2433,014609,0.19728729963008632,0.2634607480476778,0.5392519523222359,6
014611,176,219,505,900,014611,0.19555555555555557,0.24333333333333335,0.5611111111111111,6
014612,203,189,451,843,014612,0.24080664294187426,0.22419928825622776,0.534994068801898,6
014613,336,415,729,1480,014613,0.22702702702702704,0.28040540540540543,0.4925675675675676,6
014614,593,668,1426,2687,014614,0.2206922218087086,0.2486043915147004,0.530703386676591,6
014615,215,244,648,1107,014615,0.1942186088527552,0.2204155374887082,0.5853658536585366,6
014700,3004,3628,7785,14417,014700,0.20836512450579178,0.25164736075466465,0.5399875147395435,6
014701,1974,2278,3128,7380,014701,0.26747967479674795,0.3086720867208672,0.42384823848238484,5
014702,1636,1719,2166,5521,014702,0.2963231298677776,0.3113566382901648,0.3923202318420576,5
014703,647,616,1761,3024,014703,0.21395502645502645,0.2037037037037037,0.5823412698412699,6
014704,235,260,579,1074,014704,0.21880819366852886,0.24208566108007448,0.5391061452513967,6
014800,1253,1464,2695,5412,014800,0.23152254249815227,0.270509977827051,0.49796747967479676,6
014801,778,1082,2238,4098,014801,0.1898487066861884,0.26403123474865786,0.5461200585651538,6
014802,1390,1366,4023,6779,014802,0.20504499188670897,0.20150464670305354,0.5934503614102375,6
014803,1575,1887,2999,6461,014803,0.2437703141928494,0.29206005262343293,0.4641696331837177,6
014804,1728,1872,3636,7236,014804,0.23880597014925373,0.25870646766169153,0.5024875621890548,6
014805,386,371,1135,1892,014805,0.2040169133192389,0.19608879492600423,0.5998942917547568,6
014806,588,647,1978,3213,014806,0.1830065359477124,0.2013694366635543,0.6156240273887332,6
014808,320,354,1045,1719,014808,0.18615474112856312,0.20593368237347295,0.6079115764979639,6
014809,578,624,1879,3081,014809,0.18760142810775723,0.20253164556962025,0.6098669263226225,6
014810,188,173,518,879,014810,0.21387940841865757,0.19681456200227532,0.5893060295790671,6
014811,579,513,1745,2837,014811,0.20408882622488544,0.18082481494536481,0.6150863588297497,6
014900,2155,2332,5633,10120,014900,0.21294466403162055,0.23043478260869565,0.5566205533596837,6
014901,1655,1773,3654,7082,014901,0.2336910477266309,0.2503530076249647,0.5159559446484044,6
014903,1806,2019,3560,7385,014903,0.24454976303317535,0.27339201083276915,0.4820582261340555,6
014904,69,62,84,215,014904,0.3209302325581395,0.28837209302325584,0.39069767441860465,2
014905,854,853,1241,2948,014905,0.28968792401628224,0.289348710990502,0.42096336499321574,6
014906,516,575,939,2030,014906,0.2541871921182266,0.2832512315270936,0.4625615763546798,6
014907,431,407,1389,2227,014907,0.1935339021104625,0.18275707229456667,0.6237090255949708,6
014908,259,232,912,1403,014908,0.18460441910192446,0.16535994297933002,0.6500356379187455,6
014909,253,245,748,1246,014909,0.2030497592295345,0.19662921348314608,0.6003210272873194,6
015000,2061,2537,4687,9285,015000,0.22197092084006462,0.2732364028002154,0.50479267635972,6
015001,881,989,1961,3831,015001,0.22996606630122685,0.25815713912816496,0.5118767945706082,6
015002,731,694,2170,3595,015002,0.20333796940194715,0.19304589707927677,0.6036161335187761,6
015003,1052,1065,1353,3470,015003,0.3031700288184438,0.3069164265129683,0.3899135446685879,3
015004,804,746,806,2356,015004,0.34125636672325976,0.3166383701188455,0.34210526315789475,3
015005,513,477,535,1525,015005,0.33639344262295084,0.31278688524590165,0.35081967213114756,3
015006,672,706,807,2185,015006,0.30755148741418764,0.32311212814645307,0.3693363844393593,3
015100,3554,4394,8416,16364,015100,0.2171840625763872,0.26851625519432903,0.5142996822292838,6
015101,1128,1305,1830,4263,015101,0.26460239268121044,0.30612244897959184,0.42927515833919777,5
015102,939,1141,1285,3365,015102,0.27904903417533433,0.33907875185735514,0.3818722139673105,5
015200,2959,3517,6750,13226,015200,0.22372599425374262,0.26591562074701347,0.5103583849992439,6
015201,825,904,1519,3248,015201,0.25400246305418717,0.27832512315270935,0.4676724137931034,6
015202,1132,1237,2276,4645,015202,0.24370290635091496,0.26630785791173306,0.489989235737352,6
015203,320,277,654,1251,015203,0.2557953637090328,0.2214228617106315,0.5227817745803357,6
015300,1464,1658,5257,8379,015300,0.17472252058718224,0.19787564148466405,0.6274018379281537,6
015301,832,922,1416,3170,015301,0.26246056782334387,0.2908517350157729,0.4466876971608833,6
015302,379,472,651,1502,015302,0.25233022636484687,0.31424766977363516,0.43342210386151797,5
015303,385,464,612,1461,015303,0.26351813826146475,0.31759069130732376,0.4188911704312115,5
015304,501,628,551,1680,015304,0.2982142857142857,0.3738095238095238,0.3279761904761905,5
015400,2287,2896,7421,12604,015400,0.1814503332275468,0.2297683275150746,0.5887813392573786,6
015401,391,490,552,1433,015401,0.27285415212840197,0.34193998604326586,0.38520586182833216,5
015402,725,742,1092,2559,015402,0.2833137944509574,0.289957014458773,0.42672919109026963,6
015500,1760,2035,5886,9681,015500,0.181799400888338,0.2102055572771408,0.6079950418345212,6
015501,316,375,441,1132,015501,0.2791519434628975,0.33127208480565373,0.38957597173144876,5
015503,367,418,477,1262,015503,0.2908082408874802,0.3312202852614897,0.37797147385103014,5
015504,543,684,762,1989,015504,0.2730015082956259,0.3438914027149321,0.38310708898944196,5
015600,491,805,877,2173,015600,0.22595490105844454,0.3704555913483663,0.4035895075931891,5
015601,1396,1637,4511,7544,015601,0.18504772004241782,0.21699363732767762,0.5979586426299046,6
015602,542,616,1430,2588,015602,0.20942812982998454,0.23802163833075735,0.5525502318392581,6
015603,363,410,1001,1774,015603,0.20462232243517475,0.23111612175873733,0.5642615558060879,6
015700,2954,3250,8140,14344,015700,0.20593976575571668,0.2265755716675962,0.5674846625766872,6
015800,1174,1634,2229,5037,015800,0.23307524320031764,0.32439944411355964,0.4425253126861227,5
015801,599,886,2501,3986,015801,0.15027596588058204,0.2222779729051681,0.6274460612142498,6
015802,654,1111,1980,3745,015802,0.1746328437917223,0.2966622162883845,0.5287049399198932,6
015900,2138,2486,7046,11670,015900,0.18320479862896316,0.2130248500428449,0.6037703513281919,6
016000,744,948,1919,3611,016000,0.20603710883411797,0.26253115480476324,0.5314317363611188,6
016001,661,708,1891,3260,016001,0.202760736196319,0.21717791411042944,0.5800613496932515,6
016002,626,775,1836,3237,016002,0.1933889403768922,0.23941921532282978,0.567191844300278,6
016100,1833,2171,5107,9111,016100,0.20118538030951597,0.23828339369992316,0.5605312259905608,6
016200,1867,2627,3025,7519,016200,0.24830429578401383,0.34938156669769915,0.402314137518287,5
016300,2586,2584,6095,11265,016300,0.22956058588548603,0.22938304482911673,0.5410563692853972,6
016400,1957,2679,3023,7659,016400,0.25551638595116855,0.34978456717587153,0.3946990468729599,5
016500,1124,1295,4593,7012,016500,0.16029663434112948,0.18468339988590987,0.6550199657729606,6
016501,221,280,459,960,016501,0.23020833333333332,0.2916666666666667,0.478125,6
016502,498,559,1004,2061,016502,0.24163027656477437,0.2712275594371664,0.4871421639980592,6
016600,2247,2957,4048,9252,016600,0.24286640726329442,0.3196065715520968,0.43752702118460873,5
016700,1806,2093,5083,8982,016700,0.2010688042752171,0.2330215987530617,0.5659095969717213,6
016800,1240,1883,1882,5005,016800,0.24775224775224775,0.37622377622377623,0.376023976023976,5
016801,194,151,344,689,016801,0.28156748911465895,0.21915820029027577,0.49927431059506533,6
016802,273,381,551,1205,016802,0.22655601659751037,0.31618257261410787,0.45726141078838173,5
016900,2133,2414,6148,10695,016900,0.1994389901823282,0.22571294997662458,0.5748480598410473,6
016901,609,738,1417,2764,016901,0.2203328509406657,0.2670043415340087,0.5126628075253257,6
016902,281,317,452,1050,016902,0.26761904761904765,0.3019047619047619,0.43047619047619046,5
017000,1671,2344,2327,6342,017000,0.26348155156102177,0.36959949542731,0.36691895301166827,5
017005,449,477,1154,2080,017005,0.21586538461538463,0.22932692307692307,0.5548076923076923,6
017007,464,526,1143,2133,017007,0.2175339896858884,0.246601031411158,0.5358649789029536,6
017008,681,756,1829,3266,017008,0.20851194121249234,0.2314758113900796,0.560012247397428,6
017009,375,445,1104,1924,017009,0.1949064449064449,0.2312889812889813,0.5738045738045738,6
017010,815,981,2077,3873,017010,0.2104311902917635,0.2532920216886135,0.5362767880196231,6
017011,480,500,1136,2116,017011,0.22684310018903592,0.23629489603024575,0.5368620037807184,6
017012,427,430,1065,1922,017012,0.22216441207075963,0.22372528616024975,0.5541103017689907,6
017100,1705,1767,4569,8041,017100,0.21203830369357046,0.21974878746424575,0.5682129088421838,6
017200,1279,1959,2155,5393,017200,0.23715928054885962,0.3632486556647506,0.3995920637863898,5
017300,2524,2923,5392,10839,017300,0.23286281022234523,0.26967432419964943,0.49746286557800534,6
017400,905,1292,1081,3278,017400,0.2760829774252593,0.3941427699816962,0.32977425259304455,5
017401,488,741,754,1983,017401,0.24609178013111446,0.37367624810892586,0.38023197175995965,5
017402,282,372,625,1279,017402,0.22048475371383894,0.290852228303362,0.48866301798279904,6
017500,1461,1779,3705,6945,017500,0.21036717062634988,0.25615550755939526,0.5334773218142549,6
017501,211,249,249,709,017501,0.29760225669957685,0.3511988716502116,0.3511988716502116,5
017502,308,359,447,1114,017502,0.2764811490125673,0.322262118491921,0.4012567324955117,5
017600,791,1132,2050,3973,017600,0.19909388371507677,0.28492323181474954,0.5159828844701737,6
017700,1427,1612,4179,7218,017700,0.19770019395954558,0.22333056248268218,0.5789692435577722,6
017701,473,702,342,1517,017701,0.3117996044825313,0.46275543836519445,0.22544495715227422,1
017702,552,742,394,1688,017702,0.32701421800947866,0.4395734597156398,0.2334123222748815,1
017800,891,1243,1397,3531,017800,0.2523364485981308,0.35202492211838005,0.3956386292834891,5
017900,1260,1364,4057,6681,017900,0.18859452177817693,0.20416105373447088,0.6072444244873522,6
017901,551,837,437,1825,017901,0.3019178082191781,0.4586301369863014,0.23945205479452056,1
017902,442,691,312,1445,017902,0.3058823529411765,0.4782006920415225,0.21591695501730104,1
018000,1196,1712,1711,4619,018000,0.2589305044381901,0.37064299631954967,0.37042649924226023,5
018100,1321,1466,4919,7706,018100,0.1714248637425383,0.19024137036075786,0.6383337658967039,6
018101,660,975,1029,2664,018101,0.24774774774774774,0.36599099099099097,0.38626126126126126,5
018102,971,1413,1345,3729,018102,0.26039152587825154,0.37892196299275943,0.36068651112898903,5
018200,1269,1813,1610,4692,018200,0.270460358056266,0.3864023870417732,0.3431372549019608,5
018300,1446,1614,5050,8110,018300,0.1782983970406905,0.19901356350184957,0.6226880394574599,6
018301,517,699,733,1949,018301,0.2652642380708055,0.3586454592098512,0.37609030271934324,5
018302,442,674,418,1534,018302,0.288135593220339,0.439374185136897,0.27249022164276404,4
018400,1323,1851,2553,5727,018400,0.23101100052383447,0.32320586694604503,0.4457831325301205,5
018401,174,308,246,728,018401,0.23901098901098902,0.4230769230769231,0.33791208791208793,5
018402,159,302,309,770,018402,0.2064935064935065,0.3922077922077922,0.4012987012987013,5
018500,1132,1612,2317,5061,018500,0.22367121122307845,0.3185141276427583,0.4578146611341632,5
018501,706,1132,1307,3145,018501,0.224483306836248,0.35993640699523055,0.41558028616852144,5
018502,301,400,686,1387,018502,0.21701514059120403,0.2883922134102379,0.494592645998558,6
018600,964,1299,1322,3585,018600,0.2688981868898187,0.3623430962343096,0.3687587168758717,5
018700,1231,1320,3635,6186,018700,0.19899773682508892,0.2133850630455868,0.5876172001293243,6
018701,231,261,494,986,018701,0.23427991886409735,0.2647058823529412,0.5010141987829615,6
018702,656,873,1675,3204,018702,0.20474406991260924,0.27247191011235955,0.5227840199750312,6
018800,1012,1283,1513,3808,018800,0.2657563025210084,0.33692226890756305,0.39732142857142855,5
018900,2216,3035,3526,8777,018900,0.25247806767688274,0.3457901333029509,0.40173179902016637,5
018901,589,672,1360,2621,018901,0.22472338801983976,0.25639069057611596,0.5188859214040442,6
018902,449,638,1047,2134,018902,0.2104029990627929,0.29896907216494845,0.4906279287722587,6
019000,1064,1290,1668,4022,019000,0.26454500248632523,0.32073595226255597,0.41471904525111886,5
019100,1100,1111,3402,5613,019100,0.19597363263851772,0.1979333689649029,0.6060929983965794,6
019200,821,1128,939,2888,019200,0.2842797783933518,0.39058171745152354,0.32513850415512463,5
019300,2144,2620,3494,8258,019300,0.25962702833615886,0.3172681036570598,0.4231048680067813,5
019400,1486,2072,1980,5538,019400,0.26832791621524016,0.37414228963524737,0.35752979414951247,5
019500,1999,2540,4472,9011,019500,0.22183997336588615,0.281877705027189,0.49628232160692487,6
019600,1055,1447,1591,4093,019600,0.2577571463474224,0.3535304177864647,0.38871243586611287,5
019700,1387,1874,2535,5796,019700,0.23930296756383712,0.3233264320220842,0.43737060041407866,5
019701,100,104,203,407,019701,0.2457002457002457,0.25552825552825553,0.4987714987714988,6
019702,319,334,694,1347,019702,0.236822568671121,0.2479584261321455,0.5152190051967335,6
019800,1270,1557,3036,5863,019800,0.21661265563704588,0.2655637045880948,0.5178236397748592,6
019900,1976,2413,4103,8492,019900,0.23268959020254357,0.2841497880357984,0.483160621761658,6
020000,983,1321,1721,4025,020000,0.24422360248447206,0.32819875776397517,0.4275776397515528,5
020003,439,483,868,1790,020003,0.24525139664804468,0.2698324022346369,0.4849162011173184,6
020004,275,292,640,1207,020004,0.22783761391880697,0.24192212096106047,0.5302402651201326,6
020005,554,560,1066,2180,020005,0.25412844036697246,0.25688073394495414,0.4889908256880734,6
020100,2554,3567,4807,10928,020100,0.23371156661786238,0.326409224011713,0.4398792093704246,5
020101,981,1121,2157,4259,020101,0.2303357595679737,0.26320732566330124,0.506456914768725,6
020102,1590,2060,2544,6194,020102,0.25670003228931226,0.3325799160477882,0.4107200516628996,5
020200,2215,3065,3018,8298,020200,0.26693179079296214,0.3693661123162208,0.36370209689081706,5
020201,622,711,1176,2509,020201,0.24790753288162615,0.28337983260263055,0.4687126345157433,6
020202,578,603,1226,2407,020202,0.24013294557540507,0.25051931865392607,0.5093477357706688,6
020300,2093,2231,3142,7466,020300,0.28033753013661933,0.2988213233324404,0.42084114653094024,6
020301,709,939,1160,2808,020301,0.25249287749287747,0.3344017094017094,0.4131054131054131,5
020302,1066,1328,1766,4160,020302,0.25625,0.3192307692307692,0.42451923076923076,5
020400,1430,2028,2229,5687,020400,0.2514506769825919,0.3566027782662212,0.3919465447511869,5
020401,905,1225,1759,3889,020401,0.2327076369246593,0.3149910002571355,0.4523013628182052,5
020402,974,1177,1521,3672,020402,0.26525054466230935,0.3205337690631808,0.41421568627450983,5
020500,3378,4113,5999,13490,020500,0.250407709414381,0.30489251297257225,0.4446997776130467,5
020501,712,1114,660,2486,020501,0.28640386162510056,0.4481094127111826,0.26548672566371684,4
020502,231,395,215,841,020502,0.2746730083234245,0.469678953626635,0.2556480380499406,4
020600,3065,4374,4967,12406,020600,0.24705787522166694,0.3525713364501048,0.40037078832822826,5
020601,294,442,467,1203,020601,0.24438902743142144,0.36741479634247715,0.3881961762261014,5
020700,2578,3394,3887,9859,020700,0.26148696622375495,0.34425398113398925,0.3942590526422558,5
020701,1249,1688,2046,4983,020701,0.25065221753963474,0.338751755970299,0.4105960264900662,5
020702,973,1408,1489,3870,020702,0.25142118863049095,0.36382428940568473,0.3847545219638243,5
020703,1035,1516,1618,4169,020703,0.2482609738546414,0.36363636363636365,0.38810266250899494,5
020705,247,415,295,957,020705,0.258098223615465,0.4336468129571578,0.30825496342737724,5
020800,2417,3163,3449,9029,020800,0.2676929892568391,0.3503156495735962,0.3819913611695647,5
020801,805,916,2163,3884,020801,0.2072605561277034,0.23583934088568487,0.5569001029866117,6
020802,409,715,236,1360,020802,0.30073529411764705,0.5257352941176471,0.17352941176470588,1
020803,870,1036,1668,3574,020803,0.2434247341913822,0.28987129266927814,0.4667039731393397,6
020804,474,540,1292,2306,020804,0.20555073720728534,0.2341717259323504,0.5602775368603643,6
020900,2046,2963,1864,6873,020900,0.29768659973810563,0.4311072311945293,0.27120616906736505,4
020901,748,946,826,2520,020901,0.2968253968253968,0.3753968253968254,0.3277777777777778,5
020902,695,906,1156,2757,020902,0.25208560029017046,0.32861806311207836,0.4192963365977512,5
021000,3186,4124,4305,11615,021000,0.27430047352561343,0.3550581145071029,0.3706414119672837,5
021001,1003,1522,1689,4214,021001,0.23801613668723304,0.3611770289511153,0.40080683436165165,5
021002,987,1398,1574,3959,021002,0.24930538014650164,0.3531194746148017,0.39757514523869664,5
021100,2599,3408,4018,10025,021100,0.2592518703241895,0.3399501246882793,0.40079800498753115,5
021101,585,747,523,1855,021101,0.31536388140161725,0.4026954177897574,0.2819407008086253,1
021102,558,775,461,1794,021102,0.3110367892976589,0.4319955406911929,0.2569676700111483,1
021103,522,727,729,1978,021103,0.2639029322548028,0.36754297269969666,0.3685540950455005,5
021104,313,428,428,1169,021104,0.2677502138579983,0.3661248930710009,0.3661248930710009,5
021200,3865,5031,5268,14164,021200,0.2728748940977125,0.35519627223948036,0.3719288336628071,5
021201,210,297,78,585,021201,0.358974358974359,0.5076923076923077,0.13333333333333333,1
021202,329,519,196,1044,021202,0.31513409961685823,0.49712643678160917,0.18773946360153257,1
021300,1874,2413,2656,6943,021300,0.2699121417254789,0.34754428921215613,0.382543569062365,5
021301,509,651,553,1713,021301,0.2971395213076474,0.38003502626970226,0.3228254524226503,5
021302,1044,1638,886,3568,021302,0.29260089686098656,0.45908071748878926,0.2483183856502242,4
021303,1030,1265,1462,3757,021303,0.2741549108331115,0.3367048176736758,0.3891402714932127,5
021400,2167,2972,3110,8249,021400,0.26269850891017094,0.3602860952842769,0.3770153958055522,5
021401,997,1184,1275,3456,021401,0.2884837962962963,0.3425925925925926,0.3689236111111111,5
021402,475,576,542,1593,021402,0.29817953546767106,0.3615819209039548,0.34023854362837413,5
021500,1650,2214,2853,6717,021500,0.24564537740062528,0.3296114336757481,0.4247431889236266,5
021501,1012,1476,1321,3809,021501,0.265686531898136,0.38750328170123394,0.3468101864006301,5
021502,1846,2625,2224,6695,021502,0.2757281553398058,0.392083644510829,0.3321882001493652,5
021600,2569,3515,4330,10414,021600,0.2466871519108892,0.33752640676013057,0.41578644132898024,5
021601,1422,1888,1740,5050,021601,0.28158415841584156,0.37386138613861386,0.3445544554455445,5
021602,1247,1590,1975,4812,021602,0.2591438071487947,0.33042394014962595,0.4104322527015794,5
021603,470,562,776,1808,021603,0.25995575221238937,0.3108407079646018,0.42920353982300885,5
021604,516,530,561,1607,021604,0.3210952084629745,0.3298070939639079,0.3490976975731176,3
021605,501,555,446,1502,021605,0.33355525965379496,0.36950732356857524,0.2969374167776298,1
021700,2254,3282,2884,8420,021700,0.2676959619952494,0.38978622327790974,0.34251781472684084,5
021701,422,442,682,1546,021701,0.2729624838292367,0.2858990944372574,0.4411384217335058,6
021702,388,510,404,1302,021702,0.2980030721966206,0.391705069124424,0.3102918586789555,5
021703,32,45,52,129,021703,0.24806201550387597,0.3488372093023256,0.40310077519379844,5
021800,2748,3557,4110,10415,021800,0.26385021603456554,0.3415266442630821,0.39462313970235235,5
021900,1470,2240,1942,5652,021900,0.26008492569002123,0.39631988676574664,0.34359518754423213,5
022000,2263,2702,2743,7708,022000,0.2935910742086144,0.35054488842760767,0.3558640373637779,5
022001,426,619,1207,2252,022001,0.1891651865008881,0.27486678507992895,0.5359680284191829,6
022002,399,558,1011,1968,022002,0.2027439024390244,0.28353658536585363,0.5137195121951219,6
022100,1021,1568,1692,4281,022100,0.23849567857977108,0.36626956318617143,0.39523475823405746,5
022101,444,651,362,1457,022101,0.304735758407687,0.44680851063829785,0.2484557309540151,1
022102,870,1048,1011,2929,022102,0.297029702970297,0.35780129737111643,0.34516899965858655,5
022200,1975,2292,2736,7003,022200,0.2820219905754677,0.3272883050121377,0.3906897044123947,5
022300,1199,1707,1542,4448,022300,0.26955935251798563,0.38376798561151076,0.3466726618705036,5
022301,866,1277,1003,3146,022301,0.27527018436109346,0.4059122695486332,0.31881754609027335,5
022302,415,538,627,1580,022302,0.2626582278481013,0.34050632911392403,0.3968354430379747,5
022400,1654,2143,1769,5566,022400,0.2971613366870284,0.3850161696011498,0.31782249371182175,5
022401,502,749,807,2058,022401,0.24392614188532555,0.36394557823129253,0.39212827988338195,5
022403,266,485,574,1325,022403,0.20075471698113206,0.3660377358490566,0.4332075471698113,5
022404,380,633,796,1809,022404,0.21006080707573244,0.34991708126036486,0.4400221116639027,5
022500,2695,4151,3117,9963,022500,0.2705008531566797,0.41664157382314565,0.31285757302017464,5
022600,1396,1781,2993,6170,022600,0.22625607779578605,0.28865478119935173,0.4850891410048622,6
022601,334,476,412,1222,022601,0.2733224222585925,0.3895253682487725,0.337152209492635,5
022602,870,995,871,2736,022602,0.31798245614035087,0.36366959064327486,0.31834795321637427,3
022700,934,1312,1796,4042,022700,0.23107372587827807,0.32459178624443347,0.44433448787728846,5
022701,883,1163,858,2904,022701,0.3040633608815427,0.40048209366391185,0.29545454545454547,1
022702,1581,1802,2691,6074,022702,0.26028975963121503,0.2966743496871913,0.44303589068159366,6
022703,171,372,272,815,022703,0.2098159509202454,0.456441717791411,0.3337423312883436,5
022711,1188,1227,1927,4342,022711,0.27360663288807,0.28258866881621375,0.4438046982957163,6
022712,1005,1127,1679,3811,022712,0.2637103122540016,0.2957229073733928,0.4405667803726056,6
022800,1726,2494,2940,7160,022800,0.2410614525139665,0.3483240223463687,0.4106145251396648,5
022803,457,507,812,1776,022803,0.25731981981981983,0.28547297297297297,0.4572072072072072,6
022804,453,554,663,1670,022804,0.2712574850299401,0.3317365269461078,0.3970059880239521,5
022900,1427,1896,2358,5681,022900,0.25118817109663794,0.3337440591445168,0.4150677697588453,5
022901,929,1288,841,3058,022901,0.30379332897318506,0.421190320470896,0.2750163505559189,1
022902,836,1117,882,2835,022902,0.2948853615520282,0.39400352733686067,0.3111111111111111,5
023000,2627,3175,3427,9229,023000,0.2846462238595731,0.3440242713186694,0.37132950482175753,5
023001,270,377,306,953,023001,0.2833158447009444,0.3955928646379853,0.3210912906610703,5
023100,2175,2750,3465,8390,023100,0.2592371871275328,0.32777115613825986,0.4129916567342074,5
023200,2966,4077,3513,10556,023200,0.28097764304660855,0.38622584312239483,0.33279651383099657,5
023300,2615,3635,3735,9985,023300,0.26189283925888834,0.3640460691036555,0.3740610916374562,5
023301,462,722,438,1622,023301,0.2848335388409371,0.44512946979038226,0.27003699136868065,4
023302,369,608,279,1256,023302,0.29378980891719747,0.4840764331210191,0.22213375796178345,4
023400,1690,1899,1987,5576,023400,0.3030846484935438,0.3405667144906743,0.3563486370157819,3
023401,872,1005,1473,3350,023401,0.26029850746268657,0.3,0.43970149253731344,5
023402,600,676,991,2267,023402,0.2646669607410675,0.29819144243493606,0.43714159682399645,6
023404,636,834,1160,2630,023404,0.24182509505703423,0.31711026615969584,0.44106463878326996,5
023405,577,887,568,2032,023405,0.2839566929133858,0.43651574803149606,0.2795275590551181,4
023500,1506,2014,1926,5446,023500,0.27653323540213,0.369812706573632,0.353654058024238,5
023501,1398,1839,1774,5011,023501,0.2789862302933546,0.3669926162442626,0.3540211534623828,5
023502,1279,1594,1883,4756,023502,0.26892346509671994,0.3351555929352397,0.3959209419680404,5
023600,2155,2771,2508,7434,023600,0.28988431530804415,0.37274683884853377,0.33736884584342214,5
023700,1019,1423,1253,3695,023700,0.2757780784844384,0.3851150202976996,0.33910690121786197,5
023702,612,804,862,2278,023702,0.26865671641791045,0.35294117647058826,0.3784021071115013,5
023703,509,795,442,1746,023703,0.29152348224513175,0.45532646048109965,0.2531500572737686,4
023704,343,651,336,1330,023704,0.2578947368421053,0.48947368421052634,0.25263157894736843,4
023800,1612,2085,1694,5391,023800,0.29901687998516047,0.3867557039510295,0.31422741606381005,5
023801,617,774,2373,3764,023801,0.16392136025504783,0.20563230605738575,0.6304463336875664,6
023802,133,161,686,980,023802,0.1357142857142857,0.16428571428571428,0.7,6
023900,1566,2168,1565,5299,023900,0.2955274580109455,0.4091337988299679,0.29533874315908665,4
023901,843,1123,1285,3251,023901,0.25930482928329746,0.34543217471547216,0.3952629960012304,5
023902,901,1183,1545,3629,023902,0.2482777624689997,0.32598511986773215,0.4257371176632681,5
024000,1900,2507,2394,6801,024000,0.2793706807822379,0.36862226143214233,0.35200705778561975,5
024001,645,1024,1166,2835,024001,0.2275132275132275,0.3611992945326279,0.4112874779541446,5
024002,207,322,316,845,024002,0.24497041420118343,0.3810650887573965,0.3739644970414201,5
024100,1914,2659,2491,7064,024100,0.27095130237825593,0.37641562853907135,0.3526330690826727,5
024101,623,825,958,2406,024101,0.2589359933499584,0.3428927680798005,0.39817123857024106,5
024102,632,918,999,2549,024102,0.2479403687720675,0.3601412318556297,0.3919183993723029,5
024200,1211,1658,1422,4291,024200,0.2822185970636215,0.3863901188534141,0.33139128408296437,5
024201,895,1113,1194,3202,024201,0.27951280449718924,0.3475952529668957,0.37289194253591507,5
024202,345,398,493,1236,024202,0.279126213592233,0.3220064724919094,0.3988673139158576,5
024300,1461,2141,2147,5749,024300,0.25413115324404245,0.37241259349452077,0.3734562532614368,5
024301,950,1312,1384,3646,024301,0.2605595172792101,0.3598464070213933,0.37959407569939657,5
024302,1699,2303,2051,6053,024302,0.28068726251445564,0.38047249297868824,0.3388402445068561,5
024303,1039,1248,1787,4074,024303,0.2550319096710849,0.30633284241531666,0.4386352479135984,5
024400,962,1230,1318,3510,024400,0.2740740740740741,0.3504273504273504,0.3754985754985755,5
024401,923,954,1981,3858,024401,0.2392431311560394,0.24727838258164853,0.5134784862623121,6
024402,373,458,1144,1975,024402,0.1888607594936709,0.23189873417721518,0.579240506329114,6
024404,524,545,1069,2138,024404,0.245088868101029,0.254911131898971,0.5,6
024405,697,785,1203,2685,024405,0.2595903165735568,0.29236499068901306,0.4480446927374302,6
024406,308,406,481,1195,024406,0.25774058577405856,0.3397489539748954,0.40251046025104603,5
024500,2852,4266,4508,11626,024500,0.24531223120591777,0.3669361775331154,0.3877515912609668,5
024501,867,1127,1054,3048,024501,0.2844488188976378,0.369750656167979,0.3458005249343832,5
024502,847,1244,1113,3204,024502,0.26435705368289636,0.3882646691635456,0.34737827715355807,5
024600,1160,1407,1869,4436,024600,0.26149684400360684,0.3171776375112714,0.42132551848512173,5
024700,1660,2508,2690,6858,024700,0.24205307669874598,0.3657042869641295,0.39224263633712453,5
024800,992,1347,2156,4495,024800,0.2206896551724138,0.2996662958843159,0.4796440489432703,6
024900,1090,1405,1949,4444,024900,0.24527452745274528,0.31615661566156616,0.4385688568856886,5
025000,420,521,759,1700,025000,0.24705882352941178,0.3064705882352941,0.4464705882352941,5
025001,374,444,613,1431,025001,0.2613556953179595,0.31027253668763105,0.4283717679944095,5
025002,466,502,847,1815,025002,0.25674931129476586,0.27658402203856747,0.4666666666666667,6
025003,264,244,413,921,025003,0.28664495114006516,0.26492942453854507,0.44842562432138977,6
025100,2592,3511,4212,10315,025100,0.25128453708191956,0.34037809015996123,0.40833737275811927,5
025200,1239,1715,1746,4700,025200,0.26361702127659575,0.3648936170212766,0.37148936170212765,5
025300,3086,4037,4285,11408,025300,0.2705119214586255,0.3538744740532959,0.37561360448807857,5
025301,324,447,836,1607,025301,0.2016179215930305,0.27815805849408837,0.5202240199128811,6
025302,258,371,475,1104,025302,0.23369565217391305,0.33605072463768115,0.4302536231884058,5
025400,1822,2635,3113,7570,025400,0.2406869220607662,0.3480845442536328,0.4112285336856011,5
025500,2643,3630,3504,9777,025500,0.27032832157103404,0.3712795335992636,0.3583921448297024,5
025600,1056,1410,1479,3945,025600,0.267680608365019,0.3574144486692015,0.3749049429657795,5
025700,1390,1999,2408,5797,025700,0.23977919613593238,0.3448335345868553,0.41538726927721237,5
025800,831,1202,1123,3156,025800,0.2633079847908745,0.3808618504435995,0.355830164765526,5
025900,803,986,1513,3302,025900,0.24318594791035736,0.2986069049061175,0.4582071471835251,6
025901,271,383,307,961,025901,0.28199791883454733,0.39854318418314255,0.3194588969823101,5
025902,390,560,307,1257,025902,0.31026252983293556,0.44550517104216386,0.24423229912490055,1
026000,613,833,795,2241,026000,0.27353859883980364,0.3717090584560464,0.35475234270414996,5
026100,2680,4186,3580,10446,026100,0.2565575339843002,0.40072755121577636,0.34271491479992344,5
026200,1110,1429,1711,4250,026200,0.2611764705882353,0.3362352941176471,0.40258823529411764,5
026300,2606,3831,2992,9429,026300,0.27638137660409373,0.40629971364937956,0.31731890974652666,5
026400,1620,2296,2388,6304,026400,0.2569796954314721,0.36421319796954316,0.37880710659898476,5
026500,2264,3213,3381,8858,026500,0.2555881688868819,0.36272296229397155,0.38168886881914654,5
026600,594,812,803,2209,026600,0.2688999547306474,0.3675871435038479,0.36351290176550477,5
026601,266,371,768,1405,026601,0.1893238434163701,0.2640569395017794,0.5466192170818506,6
026602,433,716,1362,2511,026602,0.17244125846276384,0.2851453604141776,0.5424133811230586,6
026700,1626,2359,2534,6519,026700,0.24942475839852737,0.36186531676637523,0.3887099248350974,5
026701,347,550,597,1494,026701,0.2322623828647925,0.36813922356091033,0.39959839357429716,5
026702,580,924,1027,2531,026702,0.22915843540102726,0.3650730936388779,0.40576847096009483,5
026800,498,607,598,1703,026800,0.2924251321197886,0.35642982971227244,0.3511450381679389,5
026900,1534,2355,1903,5792,026900,0.26484806629834257,0.40659530386740333,0.32855662983425415,5
026901,337,566,461,1364,026901,0.2470674486803519,0.4149560117302053,0.3379765395894428,5
026902,372,559,560,1491,026902,0.24949698189134809,0.374916163648558,0.3755868544600939,5
027000,417,588,596,1601,027000,0.26046221111805123,0.36727045596502184,0.37226733291692693,5
027100,1856,2817,2753,7426,027100,0.24993266900080796,0.3793428494478858,0.3707244815513062,5
027200,539,694,688,1921,027200,0.2805830296720458,0.3612701717855284,0.3581467985424258,5
027300,2132,3419,4364,9915,027300,0.2150277357539082,0.3448310640443772,0.4401412002017146,5
027301,368,448,976,1792,027301,0.20535714285714285,0.25,0.5446428571428571,6
027302,302,362,841,1505,027302,0.20066445182724252,0.24053156146179402,0.5588039867109634,6
027400,506,616,633,1755,027400,0.2883190883190883,0.350997150997151,0.3606837606837607,5
027401,397,546,1222,2165,027401,0.1833718244803695,0.25219399538106235,0.5644341801385682,6
027402,266,379,875,1520,027402,0.175,0.2493421052631579,0.5756578947368421,6
027500,1204,1614,2457,5275,027500,0.22824644549763032,0.30597156398104264,0.465781990521327,5
027600,564,760,759,2083,027600,0.27076332213154103,0.36485837734037446,0.3643783005280845,5
027700,2039,3329,3085,8453,027700,0.24121613628297645,0.39382467762924406,0.3649591860877795,5
027702,614,684,1467,2765,027702,0.22206148282097649,0.247377938517179,0.5305605786618445,6
027704,446,537,956,1939,027704,0.23001547189272822,0.27694687983496646,0.4930376482723053,6
027705,516,663,1077,2256,027705,0.22872340425531915,0.29388297872340424,0.4773936170212766,6
027706,329,361,683,1373,027706,0.23962126729788782,0.2629278951201748,0.49745083758193737,6
027800,521,770,764,2055,027800,0.2535279805352798,0.3746958637469586,0.37177615571776157,5
027900,2502,3946,5007,11455,027900,0.2184199039720646,0.34447839371453515,0.4371017023134003,5
028000,302,463,519,1284,028000,0.235202492211838,0.3605919003115265,0.40420560747663553,5
028100,1618,2204,3338,7160,028100,0.2259776536312849,0.3078212290502793,0.4662011173184358,5
028200,405,595,693,1693,028200,0.23922031896042528,0.35144713526284704,0.40933254577672773,5
028300,1948,3049,3378,8375,028300,0.23259701492537313,0.3640597014925373,0.40334328358208954,5
028400,748,1084,1077,2909,028400,0.2571330354073565,0.37263664489515297,0.37023031969749054,5
028500,1370,2147,2716,6233,028500,0.21979785015241457,0.3444569228300979,0.4357452270174876,5
028501,89,95,124,308,028501,0.288961038961039,0.30844155844155846,0.4025974025974026,5
028502,323,518,276,1117,028502,0.2891674127126231,0.4637421665174575,0.24709042076991944,4
028600,623,789,1064,2476,028600,0.2516155088852989,0.31865912762520193,0.4297253634894992,5
028700,1590,2324,3097,7011,028700,0.2267864783910997,0.3314791042647269,0.44173441734417346,5
028800,850,1457,1775,4082,028800,0.2082312591866732,0.3569328760411563,0.4348358647721705,5
028900,1214,1717,2198,5129,028900,0.23669331253655684,0.33476311171768375,0.4285435757457594,5
029000,457,569,590,1616,029000,0.28279702970297027,0.3521039603960396,0.3650990099009901,5
029100,1890,3081,2558,7529,029100,0.2510293531677514,0.409217691592509,0.3397529552397397,5
029102,330,355,816,1501,029102,0.21985343104596936,0.23650899400399733,0.5436375749500333,6
029103,689,872,1637,3198,029103,0.21544715447154472,0.27267041901188244,0.5118824265165729,6
029104,647,814,1460,2921,029104,0.22149948647723383,0.27867168777815815,0.499828825744608,6
029200,236,313,341,890,029200,0.2651685393258427,0.35168539325842696,0.3831460674157303,5
029300,1422,2139,1677,5238,029300,0.27147766323024053,0.4083619702176403,0.3201603665521191,5
029301,164,224,524,912,029301,0.17982456140350878,0.24561403508771928,0.5745614035087719,6
029302,396,437,1345,2178,029302,0.18181818181818182,0.20064279155188247,0.6175390266299358,6
029400,651,1049,1133,2833,029400,0.22979174020472998,0.3702788563360395,0.3999294034592305,5
029500,1838,2511,4526,8875,029500,0.20709859154929577,0.28292957746478875,0.5099718309859155,6
029600,823,1301,1512,3636,029600,0.22634763476347636,0.3578107810781078,0.4158415841584158,5
029700,935,1209,2103,4247,029700,0.22015540381445725,0.2846715328467153,0.49517306333882743,6
029800,402,486,502,1390,029800,0.2892086330935252,0.3496402877697842,0.36115107913669064,5
029900,703,1146,822,2671,029900,0.26319730438038186,0.42905278921752155,0.3077499064020966,5
030000,1344,1887,3086,6317,030000,0.21275922114927973,0.29871774576539495,0.4885230330853253,6
030100,1411,1910,1991,5312,030100,0.265625,0.35956325301204817,0.37481174698795183,5
030200,1701,2521,3361,7583,030200,0.2243175524198866,0.33245417380983777,0.4432282737702756,5
030201,558,673,756,1987,030201,0.2808253648716658,0.33870156014091596,0.3804730749874182,5
030202,729,850,1231,2810,030202,0.2594306049822064,0.302491103202847,0.4380782918149466,5
030300,1587,2249,2371,6207,030300,0.2556790720154664,0.36233285000805543,0.38198807797647816,5
030301,486,636,1110,2232,030301,0.21774193548387097,0.2849462365591398,0.49731182795698925,6
030302,646,806,1381,2833,030302,0.2280268266854924,0.28450405930109424,0.48746911401341336,6
030400,1409,1599,1780,4788,030400,0.29427736006683375,0.33395989974937346,0.3717627401837928,5
030500,1184,1466,2080,4730,030500,0.25031712473572937,0.3099365750528541,0.4397463002114165,5
030501,336,360,569,1265,030501,0.2656126482213439,0.2845849802371542,0.449802371541502,6
030502,438,408,815,1661,030502,0.2636965683323299,0.2456351595424443,0.4906682721252258,6
030600,1621,2179,2232,6032,030600,0.2687334217506631,0.36124005305039786,0.37002652519893897,5
030700,3286,4095,4902,12283,030700,0.26752422046731256,0.33338760889033625,0.3990881706423512,5
030701,406,511,1499,2416,030701,0.16804635761589404,0.2115066225165563,0.6204470198675497,6
030800,1913,2449,2478,6840,030800,0.2796783625730994,0.3580409356725146,0.362280701754386,5
030900,1930,2561,3056,7547,030900,0.2557307539419637,0.33934013515304096,0.40492911090499534,5
030902,555,814,1019,2388,030902,0.23241206030150754,0.3408710217755444,0.4267169179229481,5
030903,452,738,785,1975,030903,0.22886075949367088,0.3736708860759494,0.39746835443037976,5
030904,267,372,469,1108,030904,0.24097472924187727,0.33574007220216606,0.4232851985559567,5
031000,1052,1277,1753,4082,031000,0.25771680548750614,0.31283684468397843,0.42944634982851543,5
031100,1159,1669,1805,4633,031100,0.25016188214979496,0.36024174401036047,0.3895963738398446,5
031200,552,770,1035,2357,031200,0.23419601187950784,0.3266864658464149,0.43911752227407724,5
031300,1031,1436,1617,4084,031300,0.2524485798237023,0.3516160626836435,0.39593535749265424,5
031400,1181,1605,1869,4655,031400,0.2537056928034372,0.3447905477980666,0.40150375939849625,5
031500,549,884,1051,2484,031500,0.2210144927536232,0.355877616747182,0.42310789049919484,5
031600,160,256,399,815,031600,0.19631901840490798,0.3141104294478528,0.48957055214723927,5
031700,423,581,1133,2137,031700,0.19794103883949463,0.27187646233036966,0.5301824988301357,6
031701,416,642,814,1872,031701,0.2222222222222222,0.34294871794871795,0.43482905982905984,5
031702,368,565,754,1687,031702,0.21813870776526378,0.33491404860699464,0.4469472436277416,5
031703,401,394,3239,4034,031703,0.09940505701536936,0.09766980664352999,0.8029251363411006,6
031704,346,389,2727,3462,031704,0.0999422299248989,0.1123627960716349,0.7876949740034662,6
031800,155,224,404,783,031800,0.1979565772669221,0.28607918263090676,0.5159642401021711,6
031900,1285,1471,2770,5526,031900,0.23253709735794426,0.2661961635903004,0.5012667390517553,6
031901,355,532,433,1320,031901,0.2689393939393939,0.403030303030303,0.328030303030303,5
031902,504,675,729,1908,031902,0.2641509433962264,0.35377358490566035,0.38207547169811323,5
032000,1062,1230,2354,4646,032000,0.22858372793801118,0.2647438656909169,0.5066724063710719,6
032100,567,889,975,2431,032100,0.2332373508844097,0.36569313039901274,0.40106951871657753,5
032101,565,492,1709,2766,032101,0.20426608821402747,0.17787418655097614,0.6178597252349964,6
032102,235,173,553,961,032102,0.2445369406867846,0.18002081165452655,0.5754422476586889,6
032200,658,736,1049,2443,032200,0.2693409742120344,0.3012689316414245,0.4293900941465411,5
032300,1296,1797,2949,6042,032300,0.21449851042701093,0.2974180734856008,0.48808341608738826,6
032400,278,371,477,1126,032400,0.2468916518650089,0.32948490230905864,0.42362344582593253,5
032402,347,427,776,1550,032402,0.2238709677419355,0.27548387096774196,0.5006451612903225,6
032403,314,392,548,1254,032403,0.2503987240829346,0.31259968102073366,0.4370015948963317,5
032404,770,820,1724,3314,032404,0.23234761617380809,0.24743512371756185,0.52021726010863,6
032500,756,1074,1069,2899,032500,0.26077957916522937,0.37047257675060363,0.36874784408416694,5
032502,447,450,938,1835,032502,0.2435967302452316,0.2452316076294278,0.5111716621253406,6
032503,476,593,1077,2146,032503,0.22180801491146318,0.27632805219012113,0.5018639328984157,6
032504,265,314,665,1244,032504,0.21302250803858522,0.25241157556270094,0.5345659163987139,6
032600,922,1235,1261,3418,032600,0.26974839087185487,0.36132241076653016,0.368929198361615,5
032601,267,318,621,1206,032601,0.22139303482587064,0.263681592039801,0.5149253731343284,6
032602,475,600,1063,2138,032602,0.22217025257249767,0.2806361085126286,0.4971936389148737,6
032700,1125,1614,1910,4649,032700,0.2419875241987524,0.34717143471714346,0.41084104108410413,5
032800,862,1345,1438,3645,032800,0.2364883401920439,0.36899862825788754,0.39451303155006856,5
032900,970,1435,1347,3752,032900,0.2585287846481876,0.3824626865671642,0.3590085287846482,5
032901,504,619,950,2073,032901,0.24312590448625182,0.2986010612638688,0.4582730342498794,6
032902,506,722,1092,2320,032902,0.21810344827586206,0.3112068965517241,0.4706896551724138,5
033000,1337,2176,2133,5646,033000,0.23680481756996102,0.38540559688274884,0.37778958554729014,5
033002,304,353,673,1330,033002,0.22857142857142856,0.2654135338345865,0.5060150375939849,6
033003,460,518,942,1920,033003,0.23958333333333334,0.26979166666666665,0.490625,6
033004,339,536,744,1619,033004,0.20938851142680667,0.33106856084002473,0.4595429277331686,5
033100,559,765,619,1943,033100,0.28769943386515695,0.39372104992279977,0.3185795162120432,5
033101,243,285,594,1122,033101,0.21657754010695188,0.2540106951871658,0.5294117647058824,6
033102,649,792,1504,2945,033102,0.2203735144312394,0.26893039049235995,0.5106960950764007,6
033200,457,674,587,1718,033200,0.2660069848661234,0.39231664726426074,0.3416763678696158,5
033201,329,509,740,1578,033201,0.20849176172370087,0.3225602027883397,0.46894803548795944,5
033202,329,553,667,1549,033202,0.21239509360877987,0.3570045190445449,0.4306003873466753,5
033300,757,994,1145,2896,033300,0.2613950276243094,0.343232044198895,0.3953729281767956,5
033400,440,479,555,1474,033400,0.29850746268656714,0.324966078697422,0.37652645861601086,5
033401,208,387,368,963,033401,0.21599169262720663,0.40186915887850466,0.3821391484942887,5
033402,739,1477,1655,3871,033402,0.19090674244381298,0.38155515370705245,0.4275381038491346,5
033500,832,1129,1436,3397,033500,0.24492198999116868,0.3323520753606123,0.422725934648219,5
033600,904,1392,1606,3902,033600,0.23167606355715017,0.3567401332649923,0.41158380317785753,5
033700,854,1286,1670,3810,033700,0.2241469816272966,0.3375328083989501,0.43832020997375326,5
033800,320,561,561,1442,033800,0.22191400832177532,0.38904299583911234,0.38904299583911234,5
033900,643,1079,1208,2930,033900,0.21945392491467577,0.368259385665529,0.41228668941979524,5
034000,588,947,932,2467,034000,0.23834616943656262,0.3838670449939197,0.3777867855695176,5
034100,269,402,541,1212,034100,0.22194719471947194,0.3316831683168317,0.44636963696369636,5
034200,817,1191,978,2986,034200,0.2736101808439384,0.398861352980576,0.3275284661754856,5
034300,723,967,953,2643,034300,0.2735527809307605,0.3658721150208097,0.3605751040484298,5
034400,142,278,331,751,034400,0.18908122503328895,0.37017310252996005,0.440745672436751,5
034500,608,841,1249,2698,034500,0.22535211267605634,0.3117123795404003,0.46293550778354337,5
034700,548,969,835,2352,034700,0.23299319727891157,0.4119897959183674,0.3550170068027211,5
034800,776,1090,1265,3131,034800,0.24784413925263493,0.3481315873522836,0.40402427339508146,5
034900,560,986,651,2197,034900,0.25489303595812474,0.4487938097405553,0.29631315430132,4
035000,536,790,947,2273,035000,0.2358117025956885,0.3475582930048394,0.41663000439947206,5
035100,1488,2170,2280,5938,035100,0.25058942404850115,0.3654429100707309,0.3839676658807679,5
035200,273,427,416,1116,035200,0.2446236559139785,0.3826164874551971,0.3727598566308244,5
035300,1007,1497,1375,3879,035300,0.2596029904614591,0.38592420726991494,0.35447280226862593,5
035400,829,1223,1251,3303,035400,0.2509839539812292,0.37026945201332123,0.3787465940054496,5
035500,888,1286,1055,3229,035500,0.2750077423350883,0.39826571694022916,0.32672654072468255,5
035600,638,836,757,2231,035600,0.28597041685342894,0.3747198565665621,0.33930972658000896,5
035601,282,400,538,1220,035601,0.23114754098360657,0.32786885245901637,0.44098360655737706,5
035602,462,653,925,2040,035602,0.22647058823529412,0.32009803921568625,0.4534313725490196,5
035700,986,1406,1186,3578,035700,0.2755729457797652,0.39295695919508106,0.33147009502515373,5
035800,1249,1988,2138,5375,035800,0.23237209302325582,0.36986046511627907,0.39776744186046514,5
035900,746,1246,883,2875,035900,0.2594782608695652,0.4333913043478261,0.3071304347826087,5
035901,596,545,696,1837,035901,0.3244420250408274,0.29667936853565596,0.3788786064235166,2
035902,113,101,120,334,035902,0.3383233532934132,0.3023952095808383,0.3592814371257485,3
036000,730,1036,1027,2793,036000,0.2613677049767275,0.37092731829573933,0.3677049767275331,5
036001,315,407,458,1180,036001,0.2669491525423729,0.34491525423728814,0.38813559322033897,5
036002,433,520,500,1453,036002,0.29800412938747417,0.35788024776324845,0.3441156228492774,5
036100,1658,2403,1714,5775,036100,0.2870995670995671,0.4161038961038961,0.2967965367965368,4
036200,365,561,441,1367,036200,0.2670080468178493,0.41038771031455745,0.32260424286759326,5
036300,1861,2758,1831,6450,036300,0.28852713178294576,0.4275968992248062,0.28387596899224804,4
036400,433,710,756,1899,036400,0.22801474460242233,0.37388098999473407,0.3981042654028436,5
036401,363,400,386,1149,036401,0.31592689295039167,0.34812880765883375,0.3359442993907746,3
036402,397,511,482,1390,036402,0.28561151079136693,0.36762589928057554,0.34676258992805753,5
036500,894,1163,950,3007,036500,0.29730628533422016,0.38676421682740275,0.3159294978383771,5
036501,652,1126,872,2650,036501,0.2460377358490566,0.4249056603773585,0.3290566037735849,5
036502,403,663,466,1532,036502,0.2630548302872063,0.43276762402088775,0.304177545691906,5
036600,946,1320,1225,3491,036600,0.2709825264967058,0.3781151532512174,0.3509023202520768,5
036700,1152,1569,1254,3975,036700,0.289811320754717,0.3947169811320755,0.3154716981132075,5
036800,921,1282,1326,3529,036800,0.26098044771890055,0.3632757155001417,0.3757438367809578,5
036900,589,823,652,2064,036900,0.2853682170542636,0.39874031007751937,0.31589147286821706,5
036901,550,813,615,1978,036901,0.2780586450960566,0.4110212335692619,0.3109201213346815,5
036902,696,961,760,2417,036902,0.2879602813405048,0.39760033098882913,0.3144393876706661,5
037000,1034,1413,1726,4173,037000,0.24778336927869637,0.3386053199137311,0.41361131080757246,5
037100,1550,2219,1962,5731,037100,0.27045890769499215,0.3871924620485081,0.34234863025649975,5
037200,630,926,894,2450,037200,0.2571428571428571,0.37795918367346937,0.36489795918367346,5
037300,1743,2684,2208,6635,037300,0.26269781461944236,0.4045214770158252,0.3327807083647325,5
037400,847,1192,969,3008,037400,0.28158244680851063,0.3962765957446808,0.3221409574468085,5
037401,336,530,732,1598,037401,0.21026282853566958,0.3316645807259074,0.45807259073842305,5
037402,424,587,745,1756,037402,0.24145785876993167,0.3342824601366743,0.42425968109339407,5
037500,1312,1745,1531,4588,037500,0.28596338273757627,0.38034001743679163,0.3336965998256321,5
037504,371,533,343,1247,037504,0.297514033680834,0.42742582197273454,0.27506014434643145,4
037600,878,1438,1436,3752,037600,0.2340085287846482,0.38326226012793174,0.38272921108742003,5
037700,550,978,959,2487,037700,0.22114997989545637,0.39324487334137515,0.3856051467631685,5
037800,319,470,410,1199,037800,0.26605504587155965,0.3919933277731443,0.3419516263552961,5
037900,1297,2090,1566,4953,037900,0.2618614980819705,0.42196648495861094,0.31617201695941854,5
038000,377,652,594,1623,038000,0.23228589032655575,0.4017252002464572,0.3659889094269871,5
038100,1581,2489,1754,5824,038100,0.27146291208791207,0.4273695054945055,0.3011675824175824,5
038200,857,1261,951,3069,038200,0.27924405343760184,0.4108830237862496,0.3098729227761486,5
038300,371,531,652,1554,038300,0.23873873873873874,0.3416988416988417,0.4195624195624196,5
038301,546,959,476,1981,038301,0.2756183745583039,0.4840989399293286,0.24028268551236748,4
038302,714,991,536,2241,038302,0.31860776439089694,0.4422132976349844,0.2391789379741187,1
038400,181,309,346,836,038400,0.21650717703349281,0.3696172248803828,0.4138755980861244,5
038500,768,1161,878,2807,038500,0.27360171001068756,0.4136088350552191,0.3127894549340933,5
038600,1040,1685,1523,4248,038600,0.2448210922787194,0.3966572504708098,0.3585216572504708,5
038700,742,1145,917,2804,038700,0.26462196861626247,0.40834522111269617,0.32703281027104136,5
038800,484,796,1014,2294,038800,0.2109851787271142,0.3469921534437663,0.4420226678291194,5
038900,852,1248,905,3005,038900,0.28352745424292847,0.4153078202995008,0.3011647254575707,5
039000,441,701,748,1890,039000,0.23333333333333334,0.3708994708994709,0.39576719576719577,5
039100,1000,1559,1100,3659,039100,0.2732987154960372,0.42607269745832194,0.3006285870456409,5
039200,470,601,680,1751,039200,0.2684180468303826,0.3432324386065106,0.3883495145631068,5
039300,1161,1890,1252,4303,039300,0.2698117592377411,0.43922844527074134,0.29095979549151757,4
039400,796,1407,1331,3534,039400,0.2252405206564799,0.39813242784380304,0.37662705149971704,5
039500,775,1252,880,2907,039500,0.26659786721706225,0.4306845545235638,0.3027175782593739,5
039600,497,808,831,2136,039600,0.23267790262172286,0.3782771535580524,0.3890449438202247,5
039700,837,1131,868,2836,039700,0.29513399153737657,0.3988011283497884,0.306064880112835,5
039800,646,1111,986,2743,039800,0.23550856726212177,0.4050309879693766,0.35946044476850164,5
039900,661,1072,822,2555,039900,0.25870841487279844,0.41956947162426617,0.32172211350293545,5
039901,485,787,458,1730,039901,0.28034682080924855,0.4549132947976879,0.26473988439306356,4
039902,475,748,436,1659,039902,0.2863170584689572,0.45087402049427366,0.2628089210367691,4
040000,404,615,622,1641,040000,0.24619134673979282,0.37477148080438755,0.37903717245581964,5
040001,522,652,941,2115,040001,0.24680851063829787,0.308274231678487,0.4449172576832151,5
040003,422,509,680,1611,040003,0.26194909993792675,0.3159528243327126,0.42209807572936064,5
040100,2378,3472,2785,8635,040100,0.27539085118702955,0.4020845396641575,0.322524609148813,5
040200,1976,2611,2756,7343,040200,0.2690998229606428,0.3555767397521449,0.3753234372872123,5
040300,2024,2990,2467,7481,040300,0.2705520652319209,0.3996791872744285,0.3297687474936506,5
040302,412,647,413,1472,040302,0.2798913043478261,0.43953804347826086,0.280570652173913,4
040303,439,629,597,1665,040303,0.26366366366366367,0.37777777777777777,0.35855855855855856,5
040304,352,553,501,1406,040304,0.2503556187766714,0.3933143669985775,0.3563300142247511,5
040400,2040,3137,2902,8079,040400,0.25250649832900113,0.38829063002846886,0.35920287164253,5
040500,1354,1993,1685,5032,040500,0.2690779014308426,0.39606518282988873,0.3348569157392687,5
040501,399,653,407,1459,040501,0.273474982864976,0.44756682659355723,0.27895819054146676,4
040502,612,995,675,2282,040502,0.26818580192813324,0.4360210341805434,0.2957931638913234,4
040600,1925,2823,3114,7862,040600,0.24484863902314932,0.35906893920122107,0.39608242177562963,5
040700,2170,3100,2687,7957,040700,0.2727158476812869,0.3895940681161242,0.3376900842025889,5
040701,291,496,454,1241,040701,0.23448831587429492,0.3996776792908944,0.36583400483481066,5
040702,654,1029,702,2385,040702,0.2742138364779874,0.43144654088050316,0.2943396226415094,4
040800,1530,2082,2149,5761,040800,0.26557889255337613,0.36139559104322166,0.3730255164034022,5
040801,503,809,865,2177,040801,0.23105190629306385,0.3716123105190629,0.3973357831878732,5
040802,491,751,599,1841,040802,0.26670287887017924,0.40793047256925585,0.3253666485605649,5
040900,1916,2916,2722,7554,040900,0.253640455387874,0.38602065131056396,0.3603388933015621,5
041000,1210,1669,1664,4543,041000,0.26634382566585957,0.3673783843275369,0.36627779000660354,5
041100,2168,2805,3220,8193,041100,0.26461613572561943,0.34236543390699375,0.3930184303673868,5
041200,1382,1687,2177,5246,041200,0.2634388105223027,0.32157834540602365,0.41498284407167363,5
041300,2311,3228,3021,8560,041300,0.2699766355140187,0.3771028037383178,0.35292056074766354,5
041400,1750,2614,2785,7149,041400,0.2447894810463002,0.36564554483144496,0.3895649741222549,5
041401,116,145,230,491,041401,0.23625254582484725,0.2953156822810591,0.4684317718940937,6
041402,132,220,237,589,041402,0.22410865874363328,0.3735144312393888,0.40237691001697795,5
041500,1656,2488,2173,6317,041500,0.2621497546303625,0.39385784391324996,0.34399240145638754,5
041600,616,628,865,2109,041600,0.29208155523944995,0.2977714556661925,0.41014698909435754,6
041700,881,1350,1152,3383,041700,0.26041974578776234,0.39905409399940883,0.34052616021282883,5
041800,1066,1534,1462,4062,041800,0.26243229935992124,0.3776464795667159,0.3599212210733629,5
041900,1139,1664,1360,4163,041900,0.27360076867643524,0.39971174633677636,0.3266874849867884,5
042000,518,905,808,2231,042000,0.23218287763334827,0.4056476916181085,0.36216943074854324,5
042100,1503,2121,1865,5489,042100,0.27382036800874476,0.38640918200036434,0.3397704499908909,5
042200,539,944,983,2466,042200,0.21857258718572586,0.38280616382806165,0.3986212489862125,5
042300,905,1309,1155,3369,042300,0.26862570495696053,0.38854259424161475,0.3428317008014248,5
042400,778,1124,1287,3189,042400,0.24396362496080276,0.352461586704296,0.40357478833490124,5
042500,1052,1586,1220,3858,042500,0.272680145152929,0.4110938310005184,0.31622602384655263,5
042600,1080,1677,1701,4458,042600,0.24226110363391656,0.37617765814266485,0.3815612382234186,5
042700,810,1450,1199,3459,042700,0.2341717259323504,0.4191962995085285,0.34663197455912115,5
042800,617,984,980,2581,042800,0.2390546299883766,0.38124757845796203,0.37969779155366135,5
042900,522,865,713,2100,042900,0.24857142857142858,0.4119047619047619,0.3395238095238095,5
042901,372,541,424,1337,042901,0.2782348541510845,0.40463724756918473,0.31712789827973076,5
042902,425,670,479,1574,042902,0.27001270648030495,0.4256670902160102,0.30432020330368487,5
043000,690,947,1028,2665,043000,0.2589118198874296,0.3553470919324578,0.38574108818011255,5
043100,1473,2134,1816,5423,043100,0.2716208740549511,0.3935091277890467,0.3348699981560022,5
043200,590,746,805,2141,043200,0.27557216254086875,0.3484353106025222,0.37599252685660906,5
043300,378,678,481,1537,043300,0.24593363695510737,0.44111906310995447,0.3129472999349382,5
043400,878,1389,1362,3629,043400,0.2419399283549187,0.38275006888950125,0.3753100027555801,5
043500,489,827,628,1944,043500,0.2515432098765432,0.4254115226337449,0.3230452674897119,5
043600,750,980,955,2685,043600,0.27932960893854747,0.3649906890130354,0.35567970204841715,5
043700,570,956,620,2146,043700,0.2656104380242311,0.44547996272134205,0.28890959925442683,4
043701,293,422,397,1112,043701,0.26348920863309355,0.37949640287769787,0.35701438848920863,5
043702,446,724,701,1871,043702,0.23837520042757884,0.38695884553714593,0.37466595403527525,5
043800,275,357,357,989,043800,0.2780586450960566,0.3609706774519717,0.3609706774519717,5
043900,654,1134,865,2653,043900,0.24651338107802487,0.42744063324538256,0.32604598567659254,5
044000,541,830,888,2259,044000,0.23948649845064188,0.367419212040726,0.3930942895086321,5
044100,591,819,676,2086,044100,0.28331735378715245,0.3926174496644295,0.32406519654841803,5
044200,560,852,1005,2417,044200,0.23169218038891187,0.35250310302027305,0.4158047165908151,5
044300,486,799,763,2048,044300,0.2373046875,0.39013671875,0.37255859375,5
044301,269,447,362,1078,044301,0.24953617810760667,0.41465677179962895,0.3358070500927644,5
044302,457,642,579,1678,044302,0.2723480333730632,0.38259833134684146,0.34505363528009536,5
044400,868,1434,1422,3724,044400,0.23308270676691728,0.38506981740064444,0.3818474758324382,5
044500,416,677,822,1915,044500,0.21723237597911227,0.35352480417754567,0.42924281984334206,5
044600,223,286,380,889,044600,0.2508436445444319,0.3217097862767154,0.42744656917885265,5
044601,271,396,359,1026,044601,0.26413255360623783,0.38596491228070173,0.34990253411306044,5
044602,349,623,458,1430,044602,0.24405594405594405,0.43566433566433566,0.3202797202797203,5
044700,373,414,431,1218,044700,0.30623973727422005,0.3399014778325123,0.35385878489326766,3
044800,620,904,1122,2646,044800,0.23431594860166288,0.3416477702191988,0.42403628117913833,5
044900,334,555,508,1397,044900,0.23908375089477452,0.39727988546886184,0.36363636363636365,5
044901,259,346,491,1096,044901,0.2363138686131387,0.3156934306569343,0.44799270072992703,5
044902,246,355,476,1077,044902,0.22841225626740946,0.329619312906221,0.44196843082636955,5
045000,258,397,462,1117,045000,0.23097582811101164,0.35541629364368843,0.41360787824529993,5
045101,230,327,457,1014,045101,0.22682445759368836,0.3224852071005917,0.45069033530571995,5
045102,257,353,479,1089,045102,0.2359963269054178,0.3241505968778696,0.4398530762167126,5
045200,296,410,547,1253,045200,0.23623304070231443,0.3272146847565842,0.43655227454110135,5
045300,257,327,389,973,045300,0.2641315519013361,0.33607399794450155,0.3997944501541624,5
045400,623,826,886,2335,045400,0.26680942184154177,0.3537473233404711,0.37944325481798713,5
045500,1249,2024,2103,5376,045500,0.23232886904761904,0.37648809523809523,0.3911830357142857,5
045600,718,996,1123,2837,045600,0.2530842439196334,0.35107507930912935,0.39584067677123724,5
045700,275,431,499,1205,045700,0.22821576763485477,0.35767634854771785,0.4141078838174274,5
045800,954,1303,1285,3542,045800,0.269339356295878,0.367871259175607,0.36278938452851495,5
045900,332,481,423,1236,045900,0.2686084142394822,0.38915857605177995,0.3422330097087379,5
046000,1060,1702,1652,4414,046000,0.2401449932034436,0.3855913004077934,0.37426370638876305,5
046100,265,328,308,901,046100,0.29411764705882354,0.36403995560488345,0.341842397336293,5
046200,588,991,734,2313,046200,0.25421530479896237,0.42844790315607434,0.31733679204496323,5
046201,2144,3678,5625,11447,046201,0.1872979820040185,0.32130689263562506,0.4913951253603564,5
046202,829,1333,1806,3968,046202,0.20892137096774194,0.3359375,0.45514112903225806,5
046300,330,478,365,1173,046300,0.2813299232736573,0.4075021312872975,0.3111679454390452,5
046400,390,464,534,1388,046400,0.28097982708933716,0.33429394812680113,0.38472622478386165,5
046500,246,381,267,894,046500,0.2751677852348993,0.4261744966442953,0.2986577181208054,4
046600,185,341,511,1037,046600,0.17839922854387658,0.32883317261330763,0.4927675988428158,5
046700,533,882,657,2072,046700,0.25723938223938225,0.42567567567567566,0.3170849420849421,5
046800,553,800,663,2016,046800,0.2743055555555556,0.3968253968253968,0.3288690476190476,5
046900,733,1006,885,2624,046900,0.27934451219512196,0.3833841463414634,0.33727134146341464,5
047000,564,797,683,2044,047000,0.2759295499021526,0.38992172211350296,0.3341487279843444,5
047100,405,519,600,1524,047100,0.265748031496063,0.3405511811023622,0.3937007874015748,5
047200,636,657,855,2148,047200,0.29608938547486036,0.3058659217877095,0.39804469273743015,5
047300,319,560,658,1537,047300,0.20754716981132076,0.36434612882238127,0.42810670136629797,5
047400,273,319,272,864,047400,0.3159722222222222,0.36921296296296297,0.3148148148148148,3
047500,428,584,744,1756,047500,0.2437357630979499,0.3325740318906606,0.42369020501138954,5
047600,581,496,624,1701,047600,0.34156378600823045,0.2915931804820694,0.36684303350970016,2
047700,415,442,1547,2404,047700,0.1726289517470882,0.18386023294509152,0.6435108153078203,6
047800,838,1131,1346,3315,047800,0.25279034690799396,0.3411764705882353,0.40603318250377074,5
047900,474,704,843,2021,047900,0.23453735774369125,0.3483424047501237,0.41712023750618504,5
048000,634,799,722,2155,048000,0.294199535962877,0.3707656612529002,0.33503480278422276,5
048100,883,1149,1519,3551,048100,0.24866234863418754,0.3235708251196846,0.42776682624612783,5
048200,735,1017,1068,2820,048200,0.26063829787234044,0.3606382978723404,0.37872340425531914,5
048300,317,397,469,1183,048300,0.2679628064243449,0.3355874894336433,0.39644970414201186,5
048400,1366,2027,2017,5410,048400,0.2524953789279113,0.3746765249537893,0.3728280961182994,5
048500,793,1082,1410,3285,048500,0.24140030441400304,0.3293759512937595,0.4292237442922374,5
048600,344,505,347,1196,048600,0.28762541806020064,0.4222408026755853,0.290133779264214,4
048800,472,513,745,1730,048800,0.2728323699421965,0.29653179190751444,0.430635838150289,6
048900,551,808,551,1910,048900,0.28848167539267017,0.42303664921465967,0.28848167539267017,4
049000,651,852,971,2474,049000,0.26313662085691186,0.34438156831042843,0.39248181083265965,5
049100,718,967,1075,2760,049100,0.26014492753623186,0.3503623188405797,0.3894927536231884,5
049200,697,1022,1348,3067,049200,0.22725790674926638,0.33322464949462016,0.43951744375611346,5
049300,793,1332,1338,3463,049300,0.2289922032919434,0.38463759745885073,0.3863701992492059,5
049301,203,275,415,893,049301,0.22732362821948487,0.3079507278835386,0.46472564389697646,5
049302,238,301,441,980,049302,0.24285714285714285,0.30714285714285716,0.45,5
049400,457,736,1034,2227,049400,0.205208801077683,0.33048944768747196,0.4643017512348451,5
049500,486,621,1171,2278,049500,0.21334503950834066,0.2726075504828797,0.5140474100087796,6
049600,705,1059,1221,2985,049600,0.23618090452261306,0.35477386934673366,0.40904522613065325,5
049700,603,724,1666,2993,049700,0.20147009689274975,0.24189776144336786,0.5566321416638824,6
049800,413,513,826,1752,049800,0.23573059360730594,0.2928082191780822,0.4714611872146119,6
049900,684,935,1459,3078,049900,0.2222222222222222,0.30376868096166343,0.47400909681611436,5
050000,710,1143,1538,3391,050000,0.20937776467118843,0.33706871129460336,0.4535535240342082,5
050100,312,395,952,1659,050100,0.18806509945750452,0.23809523809523808,0.5738396624472574,6
050101,421,369,924,1714,050101,0.2456242707117853,0.21528588098016335,0.5390898483080513,6
050102,1662,1610,3387,6659,050102,0.24958702507884067,0.2417780447514642,0.5086349301696952,6
050103,587,594,1312,2493,050103,0.23545928600080224,0.23826714801444043,0.5262735659847573,6
050104,598,683,1455,2736,050104,0.2185672514619883,0.2496345029239766,0.5317982456140351,6
050201,931,1256,1574,3761,050201,0.24754054772666845,0.33395373570858816,0.41850571656474345,5
050202,1227,1392,2382,5001,050202,0.2453509298140372,0.27834433113377327,0.47630473905218956,6
050203,553,506,1053,2112,050203,0.2618371212121212,0.23958333333333334,0.49857954545454547,6
050204,291,310,676,1277,050204,0.2278778386844166,0.2427564604541895,0.5293657008613939,6
050205,514,513,1130,2157,050205,0.2382939267501159,0.23783031988873435,0.5238757533611498,6
050300,298,378,869,1545,050300,0.1928802588996764,0.2446601941747573,0.5624595469255663,6
050301,467,751,750,1968,050301,0.23729674796747968,0.38160569105691056,0.38109756097560976,5
050302,573,791,758,2122,050302,0.2700282752120641,0.3727615457115928,0.35721017907634306,5
050400,1543,2055,2901,6499,050400,0.23742114171410986,0.3162024926911833,0.4463763655947069,5
050500,1387,1772,2480,5639,050500,0.2459655967370101,0.31424011349530057,0.4397942897676893,5
050600,750,1085,1060,2895,050600,0.25906735751295334,0.3747841105354059,0.36614853195164077,5
050601,704,676,1308,2688,050601,0.2619047619047619,0.25148809523809523,0.48660714285714285,6
050602,528,678,951,2157,050602,0.24478442280945759,0.3143254520166898,0.44089012517385257,5
050700,595,659,1051,2305,050700,0.25813449023861174,0.2859002169197397,0.4559652928416486,6
050800,563,746,814,2123,050800,0.26519076778144135,0.35138954309938764,0.38341968911917096,5
050801,525,801,559,1885,050801,0.27851458885941643,0.4249336870026525,0.296551724137931,4
050803,320,461,488,1269,050803,0.25216706067769895,0.3632781717888101,0.38455476753349094,5
050804,664,1083,1063,2810,050804,0.23629893238434163,0.38540925266903914,0.37829181494661923,5
050900,831,704,849,2384,050900,0.3485738255033557,0.2953020134228188,0.3561241610738255,2
051000,514,657,696,1867,051000,0.275307980717729,0.3519014461703267,0.3727905731119443,5
051001,506,812,616,1934,051001,0.26163391933815927,0.41985522233712513,0.3185108583247156,5
051002,575,868,753,2196,051002,0.26183970856102,0.39526411657559196,0.34289617486338797,5
051100,998,1348,1878,4224,051100,0.2362689393939394,0.3191287878787879,0.4446022727272727,5
051200,1446,2058,2126,5630,051200,0.25683836589698045,0.3655417406749556,0.37761989342806396,5
051300,1203,1594,2804,5601,051300,0.2147830744509909,0.28459203713622566,0.5006248884127834,6
051400,1133,1633,1795,4561,051400,0.24841043630782722,0.3580355185266389,0.3935540451655339,5
051500,1180,1570,2477,5227,051500,0.22575090874306486,0.30036349722594224,0.4738855940309929,5
051600,1779,2459,3353,7591,051600,0.2343564747727572,0.3239362402845475,0.4417072849426953,5
051601,650,972,684,2306,051601,0.2818733738074588,0.4215091066782307,0.2966175195143105,4
051602,481,767,545,1793,051602,0.2682654768544339,0.4277746793084216,0.30395984383714447,5
051700,659,856,1578,3093,051700,0.2130617523440026,0.2767539605560944,0.510184287099903,6
051701,366,471,590,1427,051701,0.2564821303433777,0.33006306937631397,0.41345480028030834,5
051702,341,506,642,1489,051702,0.229012760241773,0.3398253861652116,0.43116185359301545,5
051800,1516,2081,2609,6206,051800,0.2442797292942314,0.3353206574282952,0.42039961327747344,5
051900,945,1058,2273,4276,051900,0.22100093545369504,0.24742750233863423,0.5315715622076708,6
051901,436,593,1016,2045,051901,0.21320293398533008,0.2899755501222494,0.4968215158924205,6
051902,428,608,956,1992,051902,0.21485943775100402,0.30522088353413657,0.4799196787148594,5
052000,1256,1592,2029,4877,052000,0.2575353701045725,0.32643018248923517,0.41603444740619233,5
052002,224,225,496,945,052002,0.23703703703703705,0.23809523809523808,0.5248677248677248,6
052003,509,678,1288,2475,052003,0.20565656565656565,0.2739393939393939,0.5204040404040404,6
052004,665,898,1648,3211,052004,0.20710059171597633,0.27966365618187483,0.5132357521021489,6
052100,711,874,1388,2973,052100,0.2391523713420787,0.2939791456441305,0.4668684830137908,6
052101,188,287,488,963,052101,0.1952232606438214,0.2980269989615784,0.5067497403946002,6
052102,166,233,301,700,052102,0.23714285714285716,0.33285714285714285,0.43,5
052103,171,213,301,685,052103,0.24963503649635035,0.310948905109489,0.4394160583941606,5
052200,440,604,602,1646,052200,0.267314702308627,0.3669501822600243,0.36573511543134873,5
052201,489,610,1236,2335,052201,0.2094218415417559,0.26124197002141325,0.5293361884368308,6
052203,640,675,1424,2739,052203,0.23366192040890837,0.24644030668127054,0.5198977729098211,6
052204,296,348,698,1342,052204,0.22056631892697467,0.2593144560357675,0.5201192250372578,6
052300,604,849,1307,2760,052300,0.21884057971014492,0.3076086956521739,0.47355072463768116,5
052301,422,497,975,1894,052301,0.22280887011615627,0.2624076029567054,0.5147835269271384,6
052303,148,159,346,653,052303,0.22664624808575803,0.2434915773353752,0.5298621745788668,6
052304,740,953,1777,3470,052304,0.2132564841498559,0.27463976945244956,0.5121037463976945,6
052400,129,239,248,616,052400,0.20941558441558442,0.387987012987013,0.4025974025974026,5
052402,216,218,566,1000,052402,0.216,0.218,0.566,6
052403,728,989,1805,3522,052403,0.2067007382169222,0.28080636002271436,0.5124929017603634,6
052404,816,1006,2083,3905,052404,0.20896286811779768,0.25761843790012806,0.5334186939820743,6
052500,624,788,872,2284,052500,0.2732049036777583,0.3450087565674256,0.38178633975481613,5
052501,627,761,1624,3012,052501,0.20816733067729085,0.25265604249667994,0.5391766268260292,6
052502,499,692,1205,2396,052502,0.20826377295492488,0.2888146911519199,0.5029215358931552,6
052503,176,246,337,759,052503,0.2318840579710145,0.3241106719367589,0.4440052700922266,5
052600,614,956,1163,2733,052600,0.22466154409074277,0.34979875594584703,0.4255396999634102,5
052601,364,502,851,1717,052601,0.2119976703552708,0.29237041351193943,0.49563191613278973,6
052602,137,170,221,528,052602,0.25946969696969696,0.32196969696969696,0.4185606060606061,5
052603,267,393,514,1174,052603,0.227427597955707,0.33475298126064734,0.43781942078364566,5
052700,716,1011,1155,2882,052700,0.24843858431644691,0.35079805690492716,0.40076335877862596,5
052800,315,460,630,1405,052800,0.22419928825622776,0.3274021352313167,0.4483985765124555,5
052900,561,359,371,1291,052900,0.4345468628969791,0.27807900852052675,0.28737412858249417,0
053000,580,866,877,2323,053000,0.2496771416272062,0.3727938011192424,0.37752905725355146,5
053100,1442,1091,1151,3684,053100,0.3914223669923996,0.2961454940282302,0.3124321389793703,2
053200,417,585,761,1763,053200,0.23652864435621102,0.3318207600680658,0.4316505955757232,5
053300,838,500,347,1685,053300,0.4973293768545994,0.29673590504451036,0.2059347181008902,0
053400,474,702,571,1747,053400,0.271322266742988,0.4018317115054379,0.3268460217515741,5
053401,144,293,351,788,053401,0.18274111675126903,0.37182741116751267,0.44543147208121825,5
053500,709,528,501,1738,053500,0.4079401611047181,0.3037974683544304,0.2882623705408516,1
053601,121,265,292,678,053601,0.17846607669616518,0.39085545722713866,0.4306784660766962,5
053700,453,278,250,981,053700,0.4617737003058104,0.28338430173292556,0.254841997961264,0
053800,717,1016,1054,2787,053800,0.2572658772874058,0.3645496950125583,0.3781844277000359,5
053900,745,851,1036,2632,053900,0.28305471124620063,0.32332826747720367,0.39361702127659576,5
054000,356,567,645,1568,054000,0.22704081632653061,0.36160714285714285,0.41135204081632654,5
054200,848,1405,1582,3835,054200,0.2211212516297262,0.3663624511082138,0.41251629726205996,5
054300,94,92,199,385,054300,0.24415584415584415,0.23896103896103896,0.5168831168831168,6
054400,374,509,663,1546,054400,0.24191461836998707,0.3292367399741268,0.42884864165588615,5
054500,1221,1238,1092,3551,054500,0.34384680371726273,0.348634187552802,0.3075190087299352,3
054600,521,799,790,2110,054600,0.24691943127962085,0.37867298578199055,0.3744075829383886,5
054700,1043,1285,1373,3701,054700,0.2818157254796001,0.34720345852472306,0.37098081599567684,5
054800,444,572,848,1864,054800,0.23819742489270387,0.30686695278969955,0.45493562231759654,5
054900,869,1203,1885,3957,054900,0.21961081627495577,0.30401819560272936,0.4763709881223149,5
055000,393,482,568,1443,055000,0.27234927234927236,0.334026334026334,0.3936243936243936,5
055100,919,1405,2067,4391,055100,0.2092917330904122,0.3199726713732635,0.4707355955363243,5
055200,600,865,1146,2611,055200,0.2297970126388357,0.33129069322098814,0.4389122941401762,5
055300,558,782,1369,2709,055300,0.2059800664451827,0.2886674049464747,0.5053525286083426,6
055400,677,910,1135,2722,055400,0.24871418074944893,0.334313005143277,0.41697281410727405,5
055500,543,779,2200,3522,055500,0.15417376490630325,0.22118114707552528,0.6246450880181715,6
055600,557,773,1047,2377,055600,0.23432898611695416,0.3251998317206563,0.44047118216238956,5
055700,577,902,1548,3027,055700,0.19061777337297656,0.29798480343574496,0.5113974231912785,6
055800,416,600,776,1792,055800,0.23214285714285715,0.33482142857142855,0.4330357142857143,5
055900,139,255,244,638,055900,0.21786833855799373,0.3996865203761755,0.3824451410658307,5
056000,525,724,942,2191,056000,0.23961661341853036,0.33044272021907806,0.4299406663623916,5
056100,432,577,1167,2176,056100,0.19852941176470587,0.26516544117647056,0.5363051470588235,6
056200,338,397,667,1402,056200,0.24108416547788872,0.2831669044222539,0.47574893009985736,6
056300,425,625,1266,2316,056300,0.18350604490500863,0.26986183074265974,0.5466321243523317,6
056400,400,571,808,1779,056400,0.22484541877459246,0.3209668353007307,0.4541877459246768,5
056500,484,698,1536,2718,056500,0.1780721118469463,0.2568064753495217,0.565121412803532,6
056600,390,541,864,1795,056600,0.21727019498607242,0.30139275766016715,0.4813370473537604,5
056700,329,491,987,1807,056700,0.18206972883231876,0.271721084670725,0.5462091864969563,6
056800,500,833,1119,2452,056800,0.2039151712887439,0.3397226753670473,0.4563621533442088,5
056900,192,238,728,1158,056900,0.16580310880829016,0.20552677029360966,0.6286701208981001,6
057000,298,391,637,1326,057000,0.22473604826546004,0.2948717948717949,0.4803921568627451,6
057100,493,626,1422,2541,057100,0.1940181031090122,0.24635970090515544,0.5596221959858324,6
057200,647,888,722,2257,057200,0.28666371289322107,0.39344262295081966,0.3198936641559592,5
057300,275,410,902,1587,057300,0.17328292375551355,0.258349086326402,0.5683679899180845,6
057400,251,340,417,1008,057400,0.2490079365079365,0.3373015873015873,0.41369047619047616,5
057500,493,654,1379,2526,057500,0.19517022961203484,0.2589073634204275,0.5459224069675376,6
057600,323,400,506,1229,057600,0.2628152969894223,0.32546786004882017,0.41171684296175753,5
057700,242,395,622,1259,057700,0.19221604447974583,0.31374106433677523,0.49404289118347894,5
057800,350,406,458,1214,057800,0.2883031301482702,0.3344316309719934,0.3772652388797364,5
057900,331,458,719,1508,057900,0.21949602122015915,0.3037135278514589,0.47679045092838196,5
058000,653,948,1160,2761,058000,0.23650851140890983,0.3433538572980804,0.4201376312930098,5
058100,228,330,598,1156,058100,0.1972318339100346,0.28546712802768165,0.5173010380622838,6
058200,585,868,1128,2581,058200,0.22665633475397132,0.33630375823324293,0.4370399070127857,5
058300,278,396,654,1328,058300,0.20933734939759036,0.29819277108433734,0.4924698795180723,6
058400,329,490,596,1415,058400,0.2325088339222615,0.3462897526501767,0.42120141342756184,5
058500,306,491,731,1528,058500,0.20026178010471204,0.3213350785340314,0.47840314136125656,5
058600,273,345,377,995,058600,0.2743718592964824,0.34673366834170855,0.37889447236180906,5
058700,262,395,682,1339,058700,0.19566840926064227,0.2949962658700523,0.5093353248693054,6
058800,331,422,648,1401,058800,0.23625981441827265,0.3012134189864383,0.4625267665952891,5
058900,613,1003,1420,3036,058900,0.20191040843214755,0.330368906455863,0.46772068511198944,5
059000,286,467,530,1283,059000,0.22291504286827749,0.36399064692127825,0.4130943102104443,5
059100,837,1350,2084,4271,059100,0.1959728400842894,0.31608522594240224,0.4879419339733084,5
059200,501,711,892,2104,059200,0.23811787072243346,0.3379277566539924,0.42395437262357416,5
059300,615,944,1485,3044,059300,0.20203679369250985,0.31011826544021026,0.4878449408672799,5
059400,135,232,304,671,059400,0.20119225037257824,0.34575260804769004,0.45305514157973176,5
059401,755,1014,1217,2986,059401,0.25284661754855997,0.33958472873409246,0.40756865371734763,5
059402,412,549,951,1912,059402,0.21548117154811716,0.2871338912133891,0.4973849372384937,6
059500,342,613,813,1768,059500,0.19343891402714933,0.34671945701357465,0.459841628959276,5
059600,358,528,662,1548,059600,0.23126614987080105,0.34108527131782945,0.42764857881136953,5
059800,449,703,952,2104,059800,0.21340304182509506,0.3341254752851711,0.4524714828897338,5
059900,127,237,381,745,059900,0.1704697986577181,0.3181208053691275,0.5114093959731544,5
060000,621,1040,1390,3051,060000,0.20353982300884957,0.34087184529662407,0.4555883316945264,5
060100,980,1384,2056,4420,060100,0.22171945701357465,0.31312217194570136,0.465158371040724,5
060101,749,1000,1386,3135,060101,0.23891547049441786,0.3189792663476874,0.4421052631578947,5
060102,683,964,1187,2834,060102,0.24100211714890615,0.34015525758645027,0.4188426252646436,5
060200,1106,1585,1514,4205,060200,0.2630202140309156,0.3769322235434007,0.3600475624256837,5
060201,405,441,851,1697,060201,0.23865645256334708,0.25987035945786685,0.501473187978786,6
060202,445,494,809,1748,060202,0.2545766590389016,0.2826086956521739,0.46281464530892447,6
060300,971,1341,1651,3963,060300,0.2450164017158718,0.3383800151400454,0.41660358314408275,5
060301,459,437,926,1822,060301,0.2519209659714599,0.2398463227222832,0.5082327113062569,6
060302,236,230,537,1003,060302,0.23529411764705882,0.22931206380857427,0.5353938185443669,6
060400,1162,1545,1853,4560,060400,0.2548245614035088,0.33881578947368424,0.40635964912280703,5
060500,479,641,641,1761,060500,0.2720045428733674,0.3639977285633163,0.3639977285633163,5
060501,254,345,346,945,060501,0.2687830687830688,0.36507936507936506,0.36613756613756615,5
060502,224,303,317,844,060502,0.26540284360189575,0.3590047393364929,0.3755924170616114,5
060503,241,369,492,1102,060503,0.21869328493647913,0.33484573502722326,0.44646098003629764,5
060600,954,1239,1416,3609,060600,0.26433915211970077,0.343308395677473,0.3923524522028263,5
060601,288,378,589,1255,060601,0.2294820717131474,0.301195219123506,0.4693227091633466,5
060602,591,731,1047,2369,060602,0.24947235120303926,0.30856901646264245,0.44195863233431826,5
060700,444,680,567,1691,060700,0.2625665286812537,0.4021289178001183,0.33530455351862803,5
060701,848,1099,1644,3591,060701,0.23614592035644666,0.3060428849902534,0.4578111946532999,5
060702,974,1023,2044,4041,060702,0.24102944815639693,0.25315515961395696,0.5058153922296461,6
060800,1156,1477,2129,4762,060800,0.24275514489710207,0.3101637967240655,0.44708105837883244,5
060803,228,250,207,685,060803,0.33284671532846716,0.36496350364963503,0.3021897810218978,3
060804,317,320,266,903,060804,0.35105204872646734,0.35437430786268,0.29457364341085274,1
060900,595,733,660,1988,060900,0.2992957746478873,0.3687122736418511,0.3319919517102616,5
060901,455,530,873,1858,060901,0.2448869752421959,0.2852529601722282,0.4698600645855759,6
060902,283,342,338,963,060902,0.29387331256490135,0.35514018691588783,0.3509865005192108,5
061000,890,1114,1680,3684,061000,0.24158523344191096,0.30238870792616723,0.4560260586319218,5
061002,358,509,779,1646,061002,0.2174969623329283,0.3092345078979344,0.4732685297691373,5
061003,175,232,211,618,061003,0.28317152103559873,0.37540453074433655,0.3414239482200647,5
061004,608,836,874,2318,061004,0.26229508196721313,0.36065573770491804,0.3770491803278688,5
061100,1239,1365,1740,4344,061100,0.2852209944751381,0.31422651933701656,0.4005524861878453,5
061200,1127,1545,1850,4522,061200,0.24922600619195046,0.3416629809818664,0.4091110128261831,5
061300,306,418,285,1009,061300,0.30327056491575816,0.41427155599603566,0.28245787908820613,1
061301,666,932,1836,3434,061301,0.19394292370413513,0.27140361094933024,0.5346534653465347,6
061302,687,801,1481,2969,061302,0.2313910407544628,0.2697878073425396,0.49882115190299764,6
061303,165,69,122,356,061303,0.46348314606741575,0.19382022471910113,0.34269662921348315,2
061400,510,749,594,1853,061400,0.27522935779816515,0.4042093901780896,0.3205612520237453,5
061401,645,734,885,2264,061401,0.2848939929328622,0.32420494699646646,0.3909010600706714,5
061403,663,865,1450,2978,061403,0.222632639355272,0.29046339825386164,0.48690396239086636,6
061404,413,393,856,1662,061404,0.24849578820697954,0.2364620938628159,0.5150421179302046,6
061500,786,1067,1210,3063,061500,0.2566111655239961,0.3483512895853738,0.3950375448906301,5
061600,1195,1461,2129,4785,061600,0.2497387669801463,0.30532915360501567,0.44493207941483803,5
061601,179,307,388,874,061601,0.2048054919908467,0.3512585812356979,0.4439359267734554,5
061602,94,212,288,594,061602,0.15824915824915825,0.3569023569023569,0.48484848484848486,5
061700,230,311,287,828,061700,0.2777777777777778,0.3756038647342995,0.3466183574879227,5
061701,504,569,1146,2219,061701,0.22712933753943218,0.25642181162685895,0.5164488508337088,6
061702,476,571,1186,2233,061702,0.21316614420062696,0.2557098074339454,0.5311240483654277,6
061800,1539,1973,2723,6235,061800,0.24683239775461108,0.316439454691259,0.4367281475541299,5
061900,607,762,1257,2626,061900,0.23115003808073115,0.2901751713632902,0.47867479055597867,6
061901,956,1054,2427,4437,061901,0.21546089700247914,0.23754789272030652,0.5469912102772143,6
061903,634,758,1410,2802,061903,0.22626695217701642,0.2705210563882941,0.5032119914346895,6
062000,1082,1274,2283,4639,062000,0.23323992239706834,0.27462815261909895,0.49213192498383274,6
062100,928,1234,1251,3413,062100,0.271901552886024,0.36155874597128623,0.3665397011426897,5
062200,1273,1758,2197,5228,062200,0.2434965570007651,0.3362662586074981,0.4202371843917368,5
062300,408,595,813,1816,062300,0.22466960352422907,0.3276431718061674,0.44768722466960353,5
062400,468,626,785,1879,062400,0.24906865353911656,0.33315593400745075,0.4177754124534327,5
062403,680,961,1844,3485,062403,0.1951219512195122,0.2757532281205165,0.5291248206599714,6
062404,219,260,522,1001,062404,0.21878121878121878,0.2597402597402597,0.5214785214785215,6
062405,659,869,1443,2971,062405,0.22181083810164928,0.2924941097273645,0.4856950521709862,6
062406,377,515,917,1809,062406,0.2084024322830293,0.2846876727473742,0.5069098949695965,6
062500,572,814,1067,2453,062500,0.23318385650224216,0.33183856502242154,0.4349775784753363,5
062501,555,541,1440,2536,062501,0.21884858044164038,0.21332807570977919,0.5678233438485805,6
062503,567,658,1582,2807,062503,0.20199501246882792,0.2344139650872818,0.5635910224438903,6
062505,369,381,1134,1884,062505,0.19585987261146498,0.20222929936305734,0.6019108280254777,6
062506,644,648,1699,2991,062506,0.215312604480107,0.21664994984954863,0.5680374456703444,6
062507,386,455,1012,1853,062507,0.20831084727468968,0.2455477603885591,0.5461413923367512,6
062508,447,557,1261,2265,062508,0.19735099337748344,0.24591611479028697,0.5567328918322296,6
062509,331,375,922,1628,062509,0.20331695331695332,0.23034398034398035,0.5663390663390664,6
062600,479,735,1009,2223,062600,0.21547458389563653,0.33063427800269907,0.4538911381016644,5
062601,292,304,727,1323,062601,0.22071050642479215,0.22978080120937264,0.5495086923658352,6
062602,660,636,1929,3225,062602,0.20465116279069767,0.1972093023255814,0.598139534883721,6
062700,940,1203,2200,4343,062700,0.2164402486760304,0.2769974671885793,0.5065622841353903,6
062800,735,1020,1564,3319,062800,0.2214522446520036,0.3073214823742091,0.4712262729737873,5
062900,245,348,590,1183,062900,0.20710059171597633,0.294167371090448,0.4987320371935757,6
063000,183,255,295,733,063000,0.24965893587994542,0.3478854024556617,0.4024556616643929,5
063200,315,512,739,1566,063200,0.20114942528735633,0.3269476372924649,0.4719029374201788,5
063301,127,204,409,740,063301,0.17162162162162162,0.2756756756756757,0.5527027027027027,6
063302,129,193,384,706,063302,0.18271954674220964,0.273371104815864,0.5439093484419264,6
063500,216,293,576,1085,063500,0.19907834101382488,0.27004608294930876,0.5308755760368664,6
063600,133,185,377,695,063600,0.19136690647482013,0.26618705035971224,0.5424460431654676,6
063700,242,319,845,1406,063700,0.1721194879089616,0.22688477951635846,0.60099573257468,6
063800,421,661,1080,2162,063800,0.19472710453283995,0.3057354301572618,0.49953746530989823,5
063900,221,350,693,1264,063900,0.17484177215189872,0.27689873417721517,0.5482594936708861,6
064000,186,190,461,837,064000,0.2222222222222222,0.2270011947431302,0.5507765830346476,6
064101,191,248,463,902,064101,0.21175166297117518,0.2749445676274945,0.5133037694013304,6
064102,56,54,63,173,064102,0.3236994219653179,0.31213872832369943,0.36416184971098264,3
064200,248,325,464,1037,064200,0.2391513982642237,0.313404050144648,0.4474445515911283,5
064400,231,331,544,1106,064400,0.2088607594936709,0.29927667269439423,0.4918625678119349,6
064500,162,218,478,858,064500,0.1888111888111888,0.2540792540792541,0.5571095571095571,6
064600,482,723,1008,2213,064600,0.21780388612742882,0.32670582919114327,0.45549028468142794,5
064800,219,282,488,989,064800,0.22143579373104147,0.2851365015166835,0.49342770475227504,6
065000,344,623,849,1816,065000,0.1894273127753304,0.34306167400881055,0.46751101321585903,5
065200,127,194,397,718,065200,0.17688022284122562,0.27019498607242337,0.552924791086351,6
065400,434,622,1033,2089,065400,0.2077549066539014,0.2977501196744854,0.4944949736716132,6
065501,35,56,64,155,065501,0.22580645161290322,0.36129032258064514,0.4129032258064516,5
065600,590,839,1370,2799,065600,0.21078956770275098,0.29974991068238654,0.4894605216148625,6
065702,153,216,392,761,065702,0.20105124835742444,0.28383705650459923,0.5151116951379764,6
065703,227,273,719,1219,065703,0.18621821164889255,0.2239540607054963,0.5898277276456112,6
065800,198,280,512,990,065800,0.2,0.2828282828282828,0.5171717171717172,6
065900,148,216,429,793,065900,0.18663303909205547,0.2723833543505675,0.5409836065573771,6
066000,473,696,1174,2343,066000,0.20187793427230047,0.2970550576184379,0.5010670081092616,6
066100,150,188,426,764,066100,0.19633507853403143,0.24607329842931938,0.5575916230366492,6
066200,191,210,360,761,066200,0.25098554533508544,0.2759526938239159,0.4730617608409987,6
066300,243,284,684,1211,066300,0.20066061106523533,0.23451692815854666,0.564822460776218,6
066400,606,1167,1553,3326,066400,0.18220084185207455,0.3508719182200842,0.46692723992784124,5
066501,217,351,808,1376,066501,0.15770348837209303,0.2550872093023256,0.5872093023255814,6
066600,45,70,44,159,066600,0.2830188679245283,0.44025157232704404,0.27672955974842767,4
066701,224,306,625,1155,066701,0.19393939393939394,0.2649350649350649,0.5411255411255411,6
066900,152,201,413,766,066900,0.19843342036553524,0.26240208877284593,0.5391644908616188,6
067000,265,402,651,1318,067000,0.20106221547799696,0.30500758725341426,0.4939301972685888,5
067100,187,250,643,1080,067100,0.17314814814814813,0.23148148148148148,0.5953703703703703,6
067200,198,261,279,738,067200,0.2682926829268293,0.35365853658536583,0.3780487804878049,5
067400,211,320,543,1074,067400,0.19646182495344505,0.297951582867784,0.505586592178771,6
067600,209,275,394,878,067600,0.23804100227790434,0.3132118451025057,0.44874715261959,5
067700,136,206,525,867,067700,0.1568627450980392,0.23760092272202998,0.6055363321799307,6
067800,285,429,552,1266,067800,0.22511848341232227,0.33886255924170616,0.43601895734597157,5
067900,344,499,767,1610,067900,0.21366459627329193,0.3099378881987578,0.4763975155279503,5
068000,541,882,1266,2689,068000,0.20119003346969133,0.3280029750836742,0.47080699144663446,5
068200,436,597,830,1863,068200,0.23403113258185723,0.32045088566827695,0.4455179817498658,5
068300,356,530,698,1584,068300,0.22474747474747475,0.3345959595959596,0.44065656565656564,5
068600,189,238,378,805,068600,0.23478260869565218,0.2956521739130435,0.46956521739130436,6
068700,316,495,960,1771,068700,0.17843026538678713,0.2795031055900621,0.5420666290231507,6
068800,163,277,442,882,068800,0.18480725623582767,0.31405895691609975,0.5011337868480725,5
069000,474,785,1055,2314,069000,0.2048401037165082,0.33923941227312016,0.45592048401037166,5
069200,248,416,545,1209,069200,0.20512820512820512,0.34408602150537637,0.4507857733664185,5
069300,195,294,572,1061,069300,0.18378887841658811,0.2770970782280867,0.5391140433553252,6
069400,250,413,573,1236,069400,0.2022653721682848,0.33414239482200647,0.46359223300970875,5
069500,176,266,519,961,069500,0.18314255983350677,0.2767950052029136,0.5400624349635796,6
069601,332,533,778,1643,069601,0.202069385270846,0.32440657334144857,0.47352404138770543,5
069602,630,804,1445,2879,069602,0.21882598124348732,0.2792636332059743,0.5019103855505384,6
069701,298,417,708,1423,069701,0.20941672522839072,0.29304286718200984,0.49754040758959944,6
069702,249,363,752,1364,069702,0.18255131964809385,0.2661290322580645,0.5513196480938416,6
069800,149,185,380,714,069800,0.20868347338935575,0.25910364145658266,0.5322128851540616,6
070000,187,264,485,936,070000,0.1997863247863248,0.28205128205128205,0.5181623931623932,6
070100,445,562,546,1553,070100,0.2865421764327109,0.36188023180940115,0.35157759175788794,5
070101,537,543,990,2070,070101,0.2594202898550725,0.26231884057971017,0.4782608695652174,6
070102,348,500,809,1657,070102,0.2100181050090525,0.30175015087507545,0.48823174411587206,5
070200,561,664,515,1740,070200,0.32241379310344825,0.3816091954022989,0.2959770114942529,1
070201,911,1235,2111,4257,070201,0.2140004698144233,0.29011040638947616,0.49588912379610056,6
070202,58,70,64,192,070202,0.3020833333333333,0.3645833333333333,0.3333333333333333,3
070203,47,66,41,154,070203,0.3051948051948052,0.42857142857142855,0.2662337662337662,1
070300,924,1211,1497,3632,070300,0.2544052863436123,0.3334251101321586,0.4121696035242291,5
070301,713,876,1533,3122,070301,0.22837924407431134,0.2805893657911595,0.4910313901345291,6
070400,810,1064,990,2864,070400,0.28282122905027934,0.3715083798882682,0.34567039106145253,5
070401,454,429,955,1838,070401,0.2470076169749728,0.23340587595212187,0.5195865070729053,6
070500,659,820,842,2321,070500,0.2839293408013787,0.3532959931064196,0.36277466609220166,5
070600,491,699,909,2099,070600,0.23392091472129586,0.3330157217722725,0.43306336350643165,5
070601,681,759,1097,2537,070601,0.2684272763106031,0.2991722506897911,0.4324004729996058,6
070602,194,196,299,689,070602,0.28156748911465895,0.2844702467343977,0.4339622641509434,6
070700,464,676,961,2101,070700,0.22084721561161352,0.32175154688243696,0.4574012375059495,5
070701,399,456,577,1432,070701,0.2786312849162011,0.31843575418994413,0.4029329608938548,5
070702,560,596,925,2081,070702,0.2691013935607881,0.2864007688611245,0.4444978375780875,6
070800,1187,1700,1669,4556,070800,0.26053555750658475,0.373134328358209,0.36633011413520633,5
070900,984,1141,1916,4041,070900,0.24350408314773572,0.2823558525117545,0.47414006434050976,6
071000,374,516,503,1393,071000,0.2684852835606604,0.3704235463029433,0.36109117013639624,5
071100,321,401,1276,1998,071100,0.16066066066066065,0.2007007007007007,0.6386386386386387,6
071303,276,441,1376,2093,071303,0.13186813186813187,0.21070234113712374,0.6574295269947444,6
071304,427,578,1294,2299,071304,0.1857329273597216,0.2514136581122227,0.5628534145280557,6
071305,256,415,1035,1706,071305,0.15005861664712777,0.24325908558030482,0.6066822977725674,6
071306,365,519,1359,2243,071306,0.16272848863129738,0.23138653588943378,0.6058849754792688,6
071600,40,59,44,143,071600,0.27972027972027974,0.4125874125874126,0.3076923076923077,5
071701,366,447,1020,1833,071701,0.19967266775777415,0.24386252045826515,0.5564648117839607,6
071702,316,438,853,1607,071702,0.19663970130678282,0.2725575606720597,0.5308027380211574,6
071900,299,315,443,1057,071900,0.282876064333018,0.2980132450331126,0.41911069063386946,6
072000,731,888,1011,2630,072000,0.2779467680608365,0.3376425855513308,0.3844106463878327,5
072100,909,1318,1973,4200,072100,0.21642857142857144,0.3138095238095238,0.46976190476190477,5
072200,696,1035,1158,2889,072200,0.24091381100726894,0.3582554517133956,0.40083073727933544,5
072300,415,638,937,1990,072300,0.20854271356783918,0.32060301507537686,0.4708542713567839,5
072400,493,751,678,1922,072400,0.2565036420395421,0.39073881373569197,0.35275754422476585,5
072500,430,662,448,1540,072500,0.2792207792207792,0.42987012987012985,0.2909090909090909,4
072600,687,1027,1022,2736,072600,0.25109649122807015,0.3753654970760234,0.37353801169590645,5
072700,476,640,675,1791,072700,0.2657733109994416,0.3573422668900056,0.3768844221105528,5
072800,793,1070,1594,3457,072800,0.22938964420017355,0.3095169221868672,0.46109343361295924,5
072900,139,179,354,672,072900,0.20684523809523808,0.2663690476190476,0.5267857142857143,6
073000,757,1090,1053,2900,073000,0.2610344827586207,0.3758620689655172,0.36310344827586205,5
073100,121,151,367,639,073100,0.18935837245696402,0.23630672926447574,0.5743348982785602,6
073200,243,388,465,1096,073200,0.22171532846715328,0.354014598540146,0.42427007299270075,5
073400,224,332,434,990,073400,0.22626262626262628,0.33535353535353535,0.4383838383838384,5
073500,215,256,295,766,073500,0.28067885117493474,0.3342036553524804,0.38511749347258484,5
073600,381,562,596,1539,073600,0.2475633528265107,0.3651721897335932,0.387264457439896,5
073700,159,176,763,1098,073700,0.1448087431693989,0.16029143897996356,0.6948998178506375,6
073800,399,573,617,1589,073800,0.2511013215859031,0.3606041535556954,0.3882945248584015,5
073900,279,345,1267,1891,073900,0.14754098360655737,0.18244315177154943,0.6700158646218932,6
074000,660,919,796,2375,074000,0.27789473684210525,0.38694736842105265,0.3351578947368421,5
074100,184,253,808,1245,074100,0.14779116465863454,0.20321285140562248,0.648995983935743,6
074200,355,469,663,1487,074200,0.23873570948217887,0.31540013449899124,0.44586415601882984,5
074300,330,395,733,1458,074300,0.22633744855967078,0.2709190672153635,0.5027434842249657,6
074400,248,318,544,1110,074400,0.22342342342342342,0.2864864864864865,0.4900900900900901,6
074500,290,480,618,1388,074500,0.20893371757925072,0.345821325648415,0.4452449567723343,5
074600,247,321,380,948,074600,0.26054852320675104,0.33860759493670883,0.4008438818565401,5
074700,278,414,764,1456,074700,0.19093406593406592,0.28434065934065933,0.5247252747252747,6
074800,199,280,407,886,074800,0.22460496613995484,0.3160270880361174,0.45936794582392776,5
074900,158,178,490,826,074900,0.19128329297820823,0.21549636803874092,0.5932203389830508,6
075000,691,851,854,2396,075000,0.28839732888146913,0.35517529215358934,0.3564273789649416,5
075200,140,205,221,566,075200,0.24734982332155478,0.3621908127208481,0.39045936395759717,5
075400,162,189,250,601,075400,0.26955074875207985,0.3144758735440932,0.415973377703827,5
075600,216,257,442,915,075600,0.2360655737704918,0.28087431693989073,0.4830601092896175,6
075701,243,345,1220,1808,075701,0.13440265486725664,0.19081858407079647,0.6747787610619469,6
075702,238,319,1069,1626,075702,0.14637146371463713,0.1961869618696187,0.6574415744157441,6
075800,192,276,358,826,075800,0.2324455205811138,0.3341404358353511,0.43341404358353514,5
076000,598,801,795,2194,076000,0.2725615314494075,0.3650865998176846,0.3623518687329079,5
076200,525,639,625,1789,076200,0.29346003353828953,0.3571827836780324,0.34935718278367806,5
076400,426,722,714,1862,076400,0.22878625134264233,0.3877551020408163,0.38345864661654133,5
076600,268,417,394,1079,076600,0.24837812789620017,0.386468952734013,0.36515291936978683,5
076800,349,492,528,1369,076800,0.25493060628195763,0.3593864134404675,0.38568298027757486,5
076901,282,333,1180,1795,076901,0.15710306406685237,0.18551532033426185,0.6573816155988857,6
076902,123,184,391,698,076902,0.17621776504297995,0.2636103151862464,0.5601719197707736,6
077000,291,496,495,1282,077000,0.22698907956318254,0.3868954758190328,0.3861154446177847,5
077200,351,556,621,1528,077200,0.22971204188481675,0.36387434554973824,0.406413612565445,5
077300,185,279,703,1167,077300,0.1585261353898886,0.2390745501285347,0.6023993144815767,6
077400,340,595,595,1530,077400,0.2222222222222222,0.3888888888888889,0.3888888888888889,5
077500,223,284,541,1048,077500,0.21278625954198474,0.27099236641221375,0.5162213740458015,6
077600,408,625,916,1949,077600,0.20933812211390457,0.3206772703950744,0.46998460749102106,5
077902,358,448,1005,1811,077902,0.19768083931529543,0.2473771397018222,0.5549420209828824,6
077903,253,398,508,1159,077903,0.2182916307161346,0.34339948231233824,0.4383088869715272,5
077904,409,565,932,1906,077904,0.21458551941238196,0.29643231899265476,0.48898216159496327,6
077905,196,247,595,1038,077905,0.18882466281310212,0.23795761078998073,0.5732177263969171,6
077906,300,313,589,1202,077906,0.24958402662229617,0.26039933444259566,0.49001663893510816,6
077907,223,331,467,1021,077907,0.21841332027424093,0.32419196865817823,0.4573947110675808,5
077908,258,356,573,1187,077908,0.21735467565290648,0.2999157540016849,0.4827295703454086,6
078000,473,709,828,2010,078000,0.23532338308457712,0.3527363184079602,0.41194029850746267,5
078200,514,795,694,2003,078200,0.25661507738392414,0.3969046430354468,0.34648027958062905,5
078400,305,435,490,1230,078400,0.24796747967479674,0.35365853658536583,0.3983739837398374,5
078600,510,699,703,1912,078600,0.26673640167364016,0.3655857740585774,0.36767782426778245,5
078800,520,941,663,2124,078800,0.2448210922787194,0.4430320150659134,0.3121468926553672,5
079000,790,1271,1056,3117,079000,0.25344882900224575,0.40776387552133464,0.3387872954764196,5
079200,620,993,822,2435,079200,0.2546201232032854,0.4078028747433265,0.3375770020533881,5
079300,39,42,41,122,079300,0.319672131147541,0.3442622950819672,0.3360655737704918,3
079400,247,414,347,1008,079400,0.24503968253968253,0.4107142857142857,0.34424603174603174,5
079601,568,761,919,2248,079601,0.2526690391459075,0.33852313167259784,0.40880782918149466,5
079602,549,910,736,2195,079602,0.2501138952164009,0.4145785876993166,0.33530751708428247,5
079701,544,707,928,2179,079701,0.24965580541532814,0.3244607618173474,0.4258834327673245,5
079702,585,520,463,1568,079702,0.37308673469387754,0.33163265306122447,0.29528061224489793,1
079801,358,546,803,1707,079801,0.2097246631517282,0.31985940246045697,0.47041593438781487,5
079802,626,1047,1147,2820,079802,0.22198581560283687,0.37127659574468086,0.4067375886524823,5
079900,374,338,437,1149,079900,0.32550043516100957,0.29416884247171454,0.3803307223672759,2
080000,371,586,679,1636,080000,0.22677261613691932,0.3581907090464548,0.41503667481662593,5
080100,1111,1593,1626,4330,080100,0.25658198614318706,0.36789838337182446,0.37551963048498843,5
080103,500,498,1127,2125,080103,0.23529411764705882,0.2343529411764706,0.5303529411764706,6
080104,414,401,903,1718,080104,0.2409778812572759,0.23341094295692666,0.5256111757857974,6
080200,735,1173,1239,3147,080200,0.23355576739752146,0.37273593898951385,0.3937082936129647,5
080201,1082,1358,2022,4462,080201,0.24249215598386373,0.30434782608695654,0.45316001792917976,5
080202,644,721,1095,2460,080202,0.26178861788617885,0.29308943089430894,0.4451219512195122,6
080300,1175,1417,1556,4148,080300,0.28326904532304725,0.34161041465766634,0.3751205400192864,5
080301,499,493,496,1488,080301,0.3353494623655914,0.33131720430107525,0.3333333333333333,3
080302,354,373,504,1231,080302,0.2875710804224208,0.30300568643379366,0.40942323314378554,5
080400,331,515,519,1365,080400,0.2424908424908425,0.3772893772893773,0.3802197802197802,5
080401,427,371,411,1209,080401,0.3531844499586435,0.3068651778329198,0.3399503722084367,3
080402,330,338,384,1052,080402,0.31368821292775667,0.32129277566539927,0.3650190114068441,3
080501,343,404,536,1283,080501,0.2673421667965705,0.31488698363211226,0.4177708495713172,5
080502,490,639,757,1886,080502,0.2598091198303287,0.3388123011664899,0.40137857900318136,5
080600,709,1067,1343,3119,080600,0.22731644757935235,0.34209682590573903,0.43058672651490865,5
080700,405,456,667,1528,080700,0.2650523560209424,0.29842931937172773,0.43651832460732987,6
080800,208,281,288,777,080800,0.2676962676962677,0.36164736164736166,0.37065637065637064,5
080900,924,1210,1888,4022,080900,0.2297364495275982,0.3008453505718548,0.469418199900547,5
081000,1297,1831,1832,4960,081000,0.26149193548387095,0.3691532258064516,0.36935483870967745,5
081101,576,651,757,1984,081101,0.2903225806451613,0.328125,0.3815524193548387,5
081102,302,445,609,1356,081102,0.22271386430678466,0.3281710914454277,0.4491150442477876,5
081400,542,983,970,2495,081400,0.21723446893787576,0.3939879759519038,0.38877755511022044,5
081600,312,530,387,1229,081600,0.25386493083807976,0.4312449145646867,0.3148901545972335,5
081800,786,1354,1343,3483,081800,0.22566752799310938,0.38874533448176857,0.385587137525122,5
082000,560,928,775,2263,082000,0.2474591250552364,0.41007512152010606,0.3424657534246575,5
082001,575,754,741,2070,082001,0.2777777777777778,0.3642512077294686,0.35797101449275365,5
082002,149,170,209,528,082002,0.2821969696969697,0.32196969696969696,0.3958333333333333,5
082200,782,1389,990,3161,082200,0.24739006643467257,0.43941790572603606,0.31319202783929134,5
082400,528,868,579,1975,082400,0.26734177215189875,0.43949367088607594,0.2931645569620253,4
082600,668,1090,710,2468,082600,0.2706645056726094,0.44165316045380876,0.28768233387358183,4
082800,429,814,535,1778,082800,0.24128233970753657,0.4578177727784027,0.3008998875140607,5
083000,674,1182,837,2693,083000,0.2502784998143335,0.4389157073895284,0.3108057927961381,5
083200,273,467,448,1188,083200,0.2297979797979798,0.3930976430976431,0.3771043771043771,5
083400,185,309,396,890,083400,0.20786516853932585,0.3471910112359551,0.4449438202247191,5
083600,220,374,370,964,083600,0.22821576763485477,0.3879668049792531,0.38381742738589214,5
083700,567,584,681,1832,083700,0.3094978165938865,0.31877729257641924,0.37172489082969434,3
083800,586,1030,1234,2850,083800,0.2056140350877193,0.36140350877192984,0.43298245614035086,5
084000,1448,2255,2327,6030,084000,0.24013266998341626,0.37396351575456055,0.3859038142620232,5
084500,701,788,746,2235,084500,0.31364653243847873,0.35257270693512305,0.3337807606263982,3
084600,225,360,418,1003,084600,0.22432701894317048,0.3589232303090728,0.4167497507477567,5
084601,169,330,485,984,084601,0.1717479674796748,0.3353658536585366,0.4928861788617886,5
084602,93,146,191,430,084602,0.21627906976744185,0.3395348837209302,0.4441860465116279,5
084800,187,304,345,836,084800,0.2236842105263158,0.36363636363636365,0.4126794258373206,5
084900,753,722,559,2034,084900,0.3702064896755162,0.35496558505408066,0.2748279252704032,1
085000,505,717,735,1957,085000,0.258048032703117,0.3663771078180889,0.3755748594787941,5
085200,31,44,45,120,085200,0.25833333333333336,0.36666666666666664,0.375,5
085300,575,549,579,1703,085300,0.3376394597768644,0.32237228420434527,0.33998825601879035,3
085400,214,410,348,972,085400,0.22016460905349794,0.4218106995884774,0.35802469135802467,5
085500,603,666,753,2022,085500,0.29821958456973297,0.3293768545994065,0.3724035608308605,5
085600,380,666,677,1723,085600,0.22054556006964596,0.3865351131746953,0.3929193267556587,5
085700,651,659,597,1907,085700,0.3413738856843209,0.34556895647614055,0.3130571578395385,3
085800,254,428,449,1131,085800,0.22458001768346597,0.3784261715296198,0.39699381078691426,5
085900,638,718,644,2000,085900,0.319,0.359,0.322,3
086000,509,899,732,2140,086000,0.23785046728971962,0.4200934579439252,0.34205607476635513,5
086100,227,281,327,835,086100,0.2718562874251497,0.33652694610778444,0.3916167664670659,5
086200,369,622,445,1436,086200,0.25696378830083566,0.4331476323119777,0.3098885793871866,5
086300,640,827,763,2230,086300,0.28699551569506726,0.3708520179372197,0.342152466367713,5
086400,462,717,857,2036,086400,0.2269155206286837,0.35216110019646363,0.4209233791748527,5
086500,384,406,396,1186,086500,0.32377740303541314,0.342327150084317,0.33389544688026984,3
086600,321,557,539,1417,086600,0.22653493295695132,0.39308398023994356,0.3803810868031052,5
086800,370,657,461,1488,086800,0.24865591397849462,0.4415322580645161,0.30981182795698925,5
086900,221,269,246,736,086900,0.30027173913043476,0.3654891304347826,0.3342391304347826,3
087000,755,1221,1224,3200,087000,0.2359375,0.3815625,0.3825,5
087100,302,392,316,1010,087100,0.299009900990099,0.38811881188118813,0.31287128712871287,5
087200,274,498,503,1275,087200,0.21490196078431373,0.3905882352941176,0.39450980392156865,5
087401,323,538,469,1330,087401,0.24285714285714285,0.4045112781954887,0.3526315789473684,5
087600,173,323,282,778,087600,0.22236503856041132,0.41516709511568123,0.36246786632390743,5
087800,286,492,408,1186,087800,0.2411467116357504,0.4148397976391231,0.3440134907251265,5
088000,966,1447,1465,3878,088000,0.2490974729241877,0.37313047962867457,0.3777720474471377,5
088200,624,1122,916,2662,088200,0.23441021788129227,0.4214876033057851,0.3441021788129226,5
088400,994,1627,2014,4635,088400,0.21445523193096008,0.351024811218986,0.43451995685005396,5
088600,489,816,569,1874,088600,0.26093916755602986,0.43543223052294555,0.30362860192102453,5
088800,377,769,520,1666,088800,0.2262905162064826,0.4615846338535414,0.31212484993997597,5
088901,859,1088,1349,3296,088901,0.26061893203883496,0.3300970873786408,0.4092839805825243,5
089000,1134,1767,1639,4540,089000,0.2497797356828194,0.3892070484581498,0.36101321585903084,5
089200,958,1352,1871,4181,089200,0.22913178665391054,0.3233676154030136,0.44750059794307584,5
089400,389,587,463,1439,089400,0.27032661570535094,0.4079221681723419,0.32175121612230717,5
089600,429,723,423,1575,089600,0.2723809523809524,0.45904761904761904,0.26857142857142857,4
089800,239,386,289,914,089800,0.2614879649890591,0.4223194748358862,0.3161925601750547,5
090000,1161,1646,1539,4346,090000,0.26714219972388403,0.378739070409572,0.35411872986654397,5
090200,343,467,403,1213,090200,0.2827699917559769,0.38499587798845836,0.3322341302555647,5
090600,501,716,337,1554,090600,0.3223938223938224,0.46074646074646075,0.21685971685971686,1
090700,141,207,269,617,090700,0.22852512155591573,0.3354943273905997,0.4359805510534846,5
090800,436,587,320,1343,090800,0.3246463142218913,0.4370811615785555,0.23827252419955325,1
091000,781,1143,651,2575,091000,0.30330097087378644,0.4438834951456311,0.25281553398058254,1
091200,759,1040,475,2274,091200,0.3337730870712401,0.4573438874230431,0.2088830255057168,1
091600,475,746,492,1713,091600,0.2772913018096906,0.4354932866316404,0.287215411558669,4
091601,294,348,1126,1768,091601,0.166289592760181,0.19683257918552036,0.6368778280542986,6
091602,45,48,44,137,091602,0.3284671532846715,0.35036496350364965,0.32116788321167883,3
091800,338,510,404,1252,091800,0.26996805111821087,0.4073482428115016,0.3226837060702875,5
091900,459,602,764,1825,091900,0.2515068493150685,0.32986301369863014,0.41863013698630136,5
092000,645,1026,935,2606,092000,0.24750575594781274,0.39370683039140447,0.3587874136607828,5
092200,479,716,1182,2377,092200,0.20151451409339505,0.30122002524190156,0.4972654606647034,5
092400,335,573,395,1303,092400,0.25709900230237914,0.4397544128933231,0.3031465848042978,5
092500,341,442,454,1237,092500,0.27566693613581245,0.35731608730800324,0.3670169765561843,5
092800,521,862,1395,2778,092800,0.187544996400288,0.3102951763858891,0.5021598272138229,5
092900,515,719,998,2232,092900,0.2307347670250896,0.32213261648745517,0.44713261648745517,5
093000,532,785,813,2130,093000,0.24976525821596243,0.3685446009389671,0.3816901408450704,5
093200,144,265,259,668,093200,0.2155688622754491,0.3967065868263473,0.38772455089820357,5
093400,211,399,515,1125,093400,0.18755555555555556,0.3546666666666667,0.4577777777777778,5
093401,322,385,886,1593,093401,0.20213433772755807,0.24168236032642812,0.5561833019460138,6
093402,317,395,765,1477,093402,0.21462423832092078,0.2674339878131347,0.5179417738659445,6
093600,143,339,333,815,093600,0.1754601226993865,0.41595092024539876,0.4085889570552147,5
093800,615,1032,1313,2960,093800,0.20777027027027026,0.34864864864864864,0.4435810810810811,5
093900,377,518,780,1675,093900,0.22507462686567165,0.3092537313432836,0.46567164179104475,5
094000,246,342,382,970,094000,0.2536082474226804,0.3525773195876289,0.3938144329896907,5
094201,310,554,592,1456,094201,0.2129120879120879,0.3804945054945055,0.4065934065934066,5
094202,396,549,673,1618,094202,0.24474660074165636,0.33930778739184175,0.41594561186650186,5
094203,516,912,1240,2668,094203,0.1934032983508246,0.34182908545727136,0.46476761619190404,5
094401,349,549,655,1553,094401,0.2247263361236317,0.3535093367675467,0.4217643271088216,5
094402,355,495,420,1270,094402,0.2795275590551181,0.38976377952755903,0.33070866141732286,5
094500,338,504,776,1618,094500,0.2088998763906057,0.311495673671199,0.4796044499381953,5
094600,212,290,404,906,094600,0.23399558498896247,0.3200883002207506,0.445916114790287,5
094700,214,352,399,965,094700,0.22176165803108808,0.36476683937823834,0.41347150259067356,5
095000,288,545,566,1399,095000,0.2058613295210865,0.3895639742673338,0.4045746962115797,5
095400,898,1465,1557,3920,095400,0.22908163265306122,0.3737244897959184,0.3971938775510204,5
095600,390,730,758,1878,095600,0.20766773162939298,0.3887113951011715,0.4036208732694356,5
095800,345,618,612,1575,095800,0.21904761904761905,0.3923809523809524,0.38857142857142857,5
096000,39,55,53,147,096000,0.2653061224489796,0.3741496598639456,0.36054421768707484,5
096200,208,330,314,852,096200,0.24413145539906103,0.3873239436619718,0.3685446009389671,5
096400,688,1059,1133,2880,096400,0.2388888888888889,0.36770833333333336,0.39340277777777777,5
096600,207,406,470,1083,096600,0.19113573407202217,0.37488457987072943,0.4339796860572484,5
096800,181,319,330,830,096800,0.21807228915662652,0.38433734939759034,0.39759036144578314,5
097000,212,423,415,1050,097000,0.2019047619047619,0.40285714285714286,0.3952380952380952,5
097202,364,560,343,1267,097202,0.287292817679558,0.4419889502762431,0.27071823204419887,4
097203,742,1087,606,2435,097203,0.3047227926078029,0.4464065708418891,0.248870636550308,1
097204,290,532,492,1314,097204,0.2207001522070015,0.4048706240487062,0.3744292237442922,5
097300,219,257,468,944,097300,0.2319915254237288,0.2722457627118644,0.4957627118644068,6
097400,243,415,444,1102,097400,0.22050816696914702,0.3765880217785844,0.4029038112522686,5
098100,219,292,484,995,098100,0.2201005025125628,0.29346733668341707,0.4864321608040201,6
098200,470,725,454,1649,098200,0.2850212249848393,0.43966040024257125,0.27531837477258947,4
098400,194,357,409,960,098400,0.20208333333333334,0.371875,0.42604166666666665,5
098600,256,509,545,1310,098600,0.19541984732824427,0.3885496183206107,0.41603053435114506,5
098700,233,287,560,1080,098700,0.21574074074074073,0.2657407407407407,0.5185185185185185,6
098800,259,474,531,1264,098800,0.20490506329113925,0.375,0.4200949367088608,5
099000,191,318,309,818,099000,0.2334963325183374,0.38875305623471884,0.37775061124694376,5
099100,511,636,1391,2538,099100,0.2013396375098503,0.25059101654846333,0.5480693459416863,6
099200,530,974,891,2395,099200,0.22129436325678498,0.40668058455114825,0.37202505219206683,5
099400,239,368,433,1040,099400,0.2298076923076923,0.35384615384615387,0.41634615384615387,5
099600,330,562,761,1653,099600,0.1996370235934664,0.33998790078644886,0.4603750756200847,5
099701,246,267,600,1113,099701,0.2210242587601078,0.2398921832884097,0.5390835579514824,6
099703,279,354,792,1425,099703,0.1957894736842105,0.24842105263157896,0.5557894736842105,6
099704,453,572,1321,2346,099704,0.19309462915601022,0.24381926683716965,0.5630861040068201,6
099705,215,288,483,986,099705,0.21805273833671399,0.2920892494929006,0.4898580121703854,6
099800,348,620,824,1792,099800,0.19419642857142858,0.34598214285714285,0.45982142857142855,5
099801,594,1027,947,2568,099801,0.23130841121495327,0.3999221183800623,0.3687694704049844,5
099802,354,575,633,1562,099802,0.2266325224071703,0.3681177976952625,0.4052496798975672,5
099900,45,67,47,159,099900,0.2830188679245283,0.42138364779874216,0.29559748427672955,4
100000,302,423,564,1289,100000,0.2342901474010861,0.3281613653995345,0.4375484871993794,5
100100,686,905,981,2572,100100,0.2667185069984448,0.35186625194401244,0.38141524105754276,5
100200,451,744,776,1971,100200,0.22881785895484524,0.3774733637747336,0.3937087772704211,5
100300,556,1040,888,2484,100300,0.22383252818035426,0.41867954911433175,0.357487922705314,5
100400,726,1014,1230,2970,100400,0.24444444444444444,0.3414141414141414,0.41414141414141414,5
100600,873,1380,1652,3905,100600,0.2235595390524968,0.353393085787452,0.4230473751600512,5
100700,407,576,690,1673,100700,0.24327555289898387,0.3442916915720263,0.41243275552898984,5
100800,770,1203,1350,3323,100800,0.23171832681312068,0.3620222690340054,0.4062594041528739,5
100801,198,319,408,925,100801,0.21405405405405406,0.34486486486486484,0.4410810810810811,5
100802,601,1032,957,2590,100802,0.23204633204633204,0.39845559845559847,0.3694980694980695,5
100900,637,906,730,2273,100900,0.28024637043554773,0.3985921689397272,0.32116146062472506,5
101000,804,1019,1403,3226,101000,0.24922504649721017,0.31587104773713576,0.4349039057656541,5
101001,786,1305,987,3078,101001,0.2553606237816764,0.4239766081871345,0.3206627680311891,5
101002,348,458,590,1396,101002,0.2492836676217765,0.32808022922636104,0.42263610315186245,5
101100,77,97,93,267,101100,0.2883895131086142,0.36329588014981273,0.34831460674157305,5
101200,183,368,450,1001,101200,0.18281718281718282,0.3676323676323676,0.44955044955044954,5
101300,390,386,269,1045,101300,0.37320574162679426,0.369377990430622,0.2574162679425837,1
101400,473,609,798,1880,101400,0.25159574468085105,0.32393617021276594,0.42446808510638295,5
101600,371,576,512,1459,101600,0.2542837559972584,0.3947909527073338,0.35092529129540784,5
101700,986,1346,2176,4508,101700,0.21872227151730259,0.2985803016858917,0.48269742679680566,6
101800,770,1224,1430,3424,101800,0.22488317757009346,0.3574766355140187,0.41764018691588783,5
101900,776,1039,1322,3137,101900,0.24737009882052916,0.33120816066305386,0.42142174051641695,5
102000,583,875,936,2394,102000,0.24352548036758562,0.3654970760233918,0.39097744360902253,5
102100,266,324,365,955,102100,0.27853403141361255,0.3392670157068063,0.38219895287958117,5
102200,582,947,826,2355,102200,0.24713375796178344,0.4021231422505308,0.35074309978768575,5
102400,244,396,475,1115,102400,0.21883408071748878,0.35515695067264574,0.4260089686098655,5
102600,270,420,539,1229,102600,0.21969080553295361,0.3417412530512612,0.4385679414157852,5
102800,183,268,365,816,102800,0.22426470588235295,0.3284313725490196,0.44730392156862747,5
102900,264,322,606,1192,102900,0.2214765100671141,0.2701342281879195,0.5083892617449665,6
103201,488,798,501,1787,103201,0.2730833799664242,0.44655847789591496,0.28035814213766086,4
103202,397,692,639,1728,103202,0.22974537037037038,0.40046296296296297,0.3697916666666667,5
103300,336,414,788,1538,103300,0.21846553966189858,0.26918075422626786,0.5123537061118335,6
103400,456,646,477,1579,103400,0.2887903736542115,0.409119696010133,0.30208993033565545,5
103900,541,640,1194,2375,103900,0.22778947368421051,0.2694736842105263,0.5027368421052631,6
104700,618,755,1201,2574,104700,0.2400932400932401,0.29331779331779334,0.4665889665889666,6
105801,716,1171,1141,3028,105801,0.23645970937912814,0.3867239101717305,0.37681638044914134,5
105804,626,1076,1138,2840,105804,0.22042253521126762,0.3788732394366197,0.4007042253521127,5
105900,325,403,732,1460,105900,0.2226027397260274,0.276027397260274,0.5013698630136987,6
107000,85,90,191,366,107000,0.23224043715846995,0.2459016393442623,0.5218579234972678,6
107201,236,339,640,1215,107201,0.194238683127572,0.27901234567901234,0.5267489711934157,6
107202,44,46,52,142,107202,0.30985915492957744,0.323943661971831,0.36619718309859156,3
107800,323,564,958,1845,107800,0.17506775067750677,0.3056910569105691,0.5192411924119241,5
108500,205,283,516,1004,108500,0.20418326693227093,0.2818725099601594,0.5139442231075697,6
109300,257,304,613,1174,109300,0.21890971039182283,0.25894378194207834,0.5221465076660988,6
109700,128,187,420,735,109700,0.17414965986394557,0.254421768707483,0.5714285714285714,6
109800,218,347,261,826,109800,0.2639225181598063,0.42009685230024213,0.3159806295399516,5
109900,272,375,661,1308,109900,0.20795107033639143,0.286697247706422,0.5053516819571865,6
110003,396,382,764,1542,110003,0.25680933852140075,0.24773022049286642,0.49546044098573283,6
110004,206,230,337,773,110004,0.2664941785252264,0.2975420439844761,0.4359637774902975,6
110005,260,252,423,935,110005,0.27807486631016043,0.2695187165775401,0.45240641711229945,6
110101,283,258,903,1444,110101,0.19598337950138503,0.1786703601108033,0.6253462603878116,6
110102,461,416,1408,2285,110102,0.20175054704595186,0.18205689277899342,0.6161925601750547,6
110200,409,530,1422,2361,110200,0.17323168149089369,0.22448115205421432,0.602287166454892,6
110300,464,494,1348,2306,110300,0.20121422376409367,0.2142237640936687,0.5845620121422377,6
110400,481,755,543,1779,110400,0.2703766160764474,0.4243957279370433,0.30522765598650925,5
110401,288,281,771,1340,110401,0.21492537313432836,0.20970149253731343,0.5753731343283582,6
110402,314,347,956,1617,110402,0.19418676561533704,0.21459492888064316,0.5912183055040198,6
110501,271,356,834,1461,110501,0.18548939082819987,0.243668720054757,0.5708418891170431,6
110502,300,322,824,1446,110502,0.2074688796680498,0.22268326417704012,0.5698478561549101,6
110600,1257,1458,2605,5320,110600,0.2362781954887218,0.27406015037593984,0.48966165413533835,6
110801,192,212,629,1033,110801,0.18586640851887706,0.20522749273959343,0.6089060987415296,6
110803,634,567,1722,2923,110803,0.216900444748546,0.19397878891549777,0.5891207663359562,6
110901,287,319,803,1409,110901,0.2036905606813343,0.2264017033356991,0.5699077359829666,6
110902,467,626,923,2016,110902,0.2316468253968254,0.310515873015873,0.45783730158730157,5
111000,394,530,361,1285,111000,0.3066147859922179,0.41245136186770426,0.2809338521400778,1
111001,244,263,576,1083,111001,0.22530009233610343,0.24284395198522624,0.5318559556786704,6
111002,492,735,1026,2253,111002,0.21837549933422104,0.3262316910785619,0.45539280958721706,5
111100,1050,1501,1766,4317,111100,0.2432244614315497,0.3476951586750058,0.40908037989344453,5
111201,507,576,814,1897,111201,0.2672641012124407,0.3036373220875066,0.4290985767000527,5
111202,504,673,1239,2416,111202,0.20860927152317882,0.27855960264900664,0.5128311258278145,6
111300,654,739,1750,3143,111300,0.2080814508431435,0.23512567610563156,0.5567928730512249,6
111401,140,203,463,806,111401,0.17369727047146402,0.2518610421836228,0.5744416873449132,6
111402,496,593,1450,2539,111402,0.19535250098463963,0.23355651831429697,0.5710909807010635,6
111503,475,503,1160,2138,111503,0.22217025257249767,0.235266604303087,0.5425631431244153,6
111504,179,191,442,812,111504,0.2204433497536946,0.23522167487684728,0.5443349753694581,6
111505,739,936,1638,3313,111505,0.22306067008753397,0.2825233926954422,0.49441593721702387,6
111506,391,456,871,1718,111506,0.22759022118742725,0.26542491268917345,0.5069848661233993,6
111600,288,524,452,1264,111600,0.22784810126582278,0.41455696202531644,0.3575949367088608,5
111601,441,491,1148,2080,111601,0.21201923076923077,0.2360576923076923,0.551923076923077,6
111602,363,319,959,1641,111602,0.22120658135283364,0.19439366240097503,0.5843997562461913,6
111701,668,691,1625,2984,111701,0.22386058981233245,0.23156836461126004,0.5445710455764075,6
111703,327,376,920,1623,111703,0.20147874306839186,0.23166974738139248,0.5668515095502157,6
111704,393,355,945,1693,111704,0.232132309509746,0.20968694624926165,0.5581807442409923,6
111800,304,453,390,1147,111800,0.26503923278116825,0.3949433304272014,0.3400174367916303,5
111801,674,748,1766,3188,111801,0.21141781681304894,0.23462986198243413,0.553952321204517,6
111802,342,325,905,1572,111802,0.21755725190839695,0.20674300254452926,0.5756997455470738,6
111803,306,302,789,1397,111803,0.21904080171796708,0.21617752326413744,0.5647816750178954,6
111804,297,274,672,1243,111804,0.23893805309734514,0.22043443282381336,0.5406275140788415,6
111900,546,599,1551,2696,111900,0.20252225519287834,0.22218100890207715,0.5752967359050445,6
112000,354,547,373,1274,112000,0.2778649921507064,0.4293563579277865,0.29277864992150704,4
112001,481,576,1285,2342,112001,0.2053800170794193,0.24594363791631085,0.5486763450042699,6
112002,483,486,1390,2359,112002,0.20474777448071216,0.2060194997880458,0.5892327257312421,6
112102,337,383,1099,1819,112102,0.18526663001649257,0.21055525013743814,0.6041781198460693,6
112103,499,483,1265,2247,112103,0.22207387627948375,0.21495327102803738,0.5629728526924789,6
112104,230,246,752,1228,112104,0.18729641693811075,0.2003257328990228,0.6123778501628665,6
112200,340,531,407,1278,112200,0.26604068857589985,0.4154929577464789,0.31846635367762127,5
112204,391,378,1117,1886,112204,0.2073170731707317,0.20042417815482502,0.5922587486744433,6
112206,696,717,2086,3499,112206,0.198913975421549,0.2049156901971992,0.5961703343812518,6
112210,689,758,1922,3369,112210,0.20451172454734343,0.22499257940041556,0.570495696052241,6
112211,402,478,1231,2111,112211,0.19043107531975367,0.22643297015632402,0.5831359545239223,6
112212,309,290,947,1546,112212,0.1998706338939198,0.18758085381630013,0.61254851228978,6
112213,502,565,1444,2511,112213,0.19992035045798487,0.22500995619275188,0.5750696933492633,6
112214,577,612,1572,2761,112214,0.208982252806954,0.22165881926838102,0.569358927924665,6
112300,190,221,393,804,112300,0.236318407960199,0.27487562189054726,0.48880597014925375,6
112400,336,612,443,1391,112400,0.2415528396836808,0.4399712437095615,0.3184759166067577,5
112600,429,684,476,1589,112600,0.26998112020138454,0.4304594084329767,0.29955947136563876,4
112800,401,658,428,1487,112800,0.269670477471419,0.4425016812373907,0.2878278412911903,4
112900,171,221,437,829,112900,0.20627261761158022,0.26658624849215923,0.5271411338962606,6
113000,425,712,511,1648,113000,0.25788834951456313,0.4320388349514563,0.3100728155339806,5
113200,224,384,352,960,113200,0.23333333333333334,0.4,0.36666666666666664,5
113300,130,166,354,650,113300,0.2,0.2553846153846154,0.5446153846153846,6
113400,315,490,228,1033,113400,0.30493707647628265,0.4743465634075508,0.2207163601161665,1
113900,232,321,664,1217,113900,0.19063270336894,0.2637633525061627,0.5456039441248973,6
114100,206,281,576,1063,114100,0.19379115710253997,0.264346190028222,0.541862652869238,6
114201,178,281,256,715,114201,0.24895104895104894,0.393006993006993,0.35804195804195804,5
114202,272,500,390,1162,114202,0.23407917383820998,0.43029259896729777,0.33562822719449226,5
114400,293,456,292,1041,114400,0.2814601344860711,0.43804034582132567,0.2804995196926033,4
114600,313,510,378,1201,114600,0.26061615320566195,0.42464612822647796,0.3147377185678601,5
114700,147,185,443,775,114700,0.1896774193548387,0.23870967741935484,0.5716129032258065,6
115000,284,498,344,1126,115000,0.2522202486678508,0.4422735346358792,0.30550621669627,5
115100,138,163,293,594,115100,0.23232323232323232,0.27441077441077444,0.49326599326599324,6
115200,326,486,394,1206,115200,0.2703150912106136,0.40298507462686567,0.32669983416252074,5
115500,161,247,320,728,115500,0.22115384615384615,0.3392857142857143,0.43956043956043955,5
115600,458,798,393,1649,115600,0.2777440873256519,0.4839296543359612,0.23832625833838691,4
115700,290,368,484,1142,115700,0.2539404553415061,0.3222416812609457,0.4238178633975482,5
115800,253,513,407,1173,115800,0.21568627450980393,0.4373401534526854,0.34697357203751067,5
115900,365,445,500,1310,115900,0.2786259541984733,0.33969465648854963,0.3816793893129771,5
116000,295,445,374,1114,116000,0.26481149012567323,0.3994614003590664,0.3357271095152603,5
116100,428,449,583,1460,116100,0.29315068493150687,0.30753424657534245,0.3993150684931507,5
116200,218,359,366,943,116200,0.23117709437963946,0.3806998939554613,0.38812301166489926,5
116300,777,992,869,2638,116300,0.29454131918119786,0.37604245640636846,0.3294162244124337,5
116400,321,465,491,1277,116400,0.2513703993735317,0.36413469068128423,0.38449490994518404,5
116600,315,488,377,1180,116600,0.2669491525423729,0.4135593220338983,0.31949152542372883,5
116700,201,257,205,663,116700,0.3031674208144796,0.38763197586727,0.3092006033182504,3
116800,254,404,252,910,116800,0.27912087912087913,0.44395604395604393,0.27692307692307694,4
117000,223,384,193,800,117000,0.27875,0.48,0.24125,4
117100,243,337,352,932,117100,0.2607296137339056,0.361587982832618,0.3776824034334764,5
117201,279,488,342,1109,117201,0.2515779981965735,0.4400360685302074,0.3083859332732191,5
117202,401,766,506,1673,117202,0.23968918111177526,0.45786013150029886,0.30245068738792585,5
117400,464,742,516,1722,117400,0.2694541231126597,0.43089430894308944,0.29965156794425085,4
117500,364,427,738,1529,117500,0.2380640941792021,0.27926749509483323,0.48266841072596467,6
117601,315,499,345,1159,117601,0.271786022433132,0.43054357204486626,0.29767040552200175,4
117602,344,619,386,1349,117602,0.25500370644922166,0.4588584136397331,0.2861378799110452,4
117800,218,367,229,814,117800,0.2678132678132678,0.45085995085995084,0.28132678132678135,4
118000,45,83,40,168,118000,0.26785714285714285,0.49404761904761907,0.23809523809523808,4
118100,172,223,374,769,118100,0.22366710013003901,0.28998699609882966,0.48634590377113135,6
118201,364,573,415,1352,118201,0.2692307692307692,0.4238165680473373,0.3069526627218935,5
118202,330,621,394,1345,118202,0.24535315985130113,0.4617100371747212,0.2929368029739777,4
118400,530,899,615,2044,118400,0.25929549902152643,0.4398238747553816,0.300880626223092,5
118500,165,206,252,623,118500,0.26484751203852325,0.3306581059390048,0.4044943820224719,5
118600,330,558,422,1310,118600,0.25190839694656486,0.4259541984732824,0.32213740458015266,5
118700,266,320,291,877,118700,0.3033067274800456,0.36488027366020526,0.33181299885974913,3
118800,515,930,483,1928,118800,0.2671161825726141,0.4823651452282158,0.2505186721991701,4
118900,243,285,314,842,118900,0.28859857482185275,0.33847980997624705,0.37292161520190026,5
119000,278,451,261,990,119000,0.2808080808080808,0.45555555555555555,0.2636363636363636,4
119100,298,396,366,1060,119100,0.2811320754716981,0.37358490566037733,0.3452830188679245,5
119200,324,510,399,1233,119200,0.26277372262773724,0.41362530413625304,0.3236009732360097,5
119300,227,238,331,796,119300,0.2851758793969849,0.2989949748743719,0.4158291457286432,6
119400,458,685,512,1655,119400,0.2767371601208459,0.41389728096676737,0.3093655589123867,5
119500,166,168,275,609,119500,0.27257799671592775,0.27586206896551724,0.451559934318555,6
119600,607,950,671,2228,119600,0.27244165170556556,0.4263913824057451,0.3011669658886894,5
119800,354,600,397,1351,119800,0.26202812731310143,0.44411547002220575,0.2938564026646928,4
119900,192,209,247,648,119900,0.2962962962962963,0.32253086419753085,0.38117283950617287,5
120000,555,805,841,2201,120000,0.2521581099500227,0.3657428441617447,0.3820990458882326,5
120100,211,204,214,629,120100,0.3354531001589825,0.32432432432432434,0.34022257551669316,3
120200,286,371,282,939,120200,0.3045793397231097,0.3951011714589989,0.3003194888178914,3
120300,199,233,277,709,120300,0.28067700987306066,0.32863187588152326,0.3906911142454161,5
120500,283,389,334,1006,120500,0.2813121272365805,0.3866799204771372,0.3320079522862823,5
120700,282,314,527,1123,120700,0.25111308993766696,0.27960819234194123,0.4692787177203918,6
120800,898,1641,1094,3633,120800,0.24717864024222405,0.4516928158546656,0.3011285439031104,5
121000,456,736,394,1586,121000,0.287515762925599,0.4640605296343001,0.2484237074401009,4
121100,46,48,49,143,121100,0.32167832167832167,0.3356643356643357,0.34265734265734266,3
121400,490,735,404,1629,121400,0.30079803560466545,0.45119705340699817,0.2480049109883364,1
121500,383,490,549,1422,121500,0.26933895921237694,0.34458509142053445,0.3860759493670886,5
122000,559,972,776,2307,122000,0.2423060251408756,0.4213263979193758,0.3363675769397486,5
122300,801,1078,1679,3558,122300,0.2251264755480607,0.30297920179876336,0.47189432265317593,5
122403,324,469,574,1367,122403,0.2370153621068032,0.34308705193855155,0.4198975859546452,5
122404,466,591,981,2038,122404,0.22865554465161925,0.2899901864573111,0.4813542688910697,6
122405,405,593,708,1706,122405,0.23739742086752638,0.34759671746776083,0.41500586166471276,5
122406,604,1004,810,2418,122406,0.24979321753515302,0.4152191894127378,0.3349875930521092,5
122501,517,840,685,2042,122501,0.2531831537708129,0.41136141038197843,0.3354554358472086,5
122502,657,974,1040,2671,122502,0.24597529015350056,0.3646574316735305,0.3893672781729689,5
122601,714,859,1418,2991,122601,0.238716148445336,0.2871949180875961,0.4740889334670679,6
122602,540,647,1144,2331,122602,0.23166023166023167,0.2775632775632776,0.49077649077649077,6
122603,737,816,1599,3152,122603,0.2338197969543147,0.25888324873096447,0.5072969543147208,6
122701,769,1013,1866,3648,122701,0.21080043859649122,0.27768640350877194,0.5115131578947368,6
122702,552,724,790,2066,122702,0.2671829622458858,0.3504356243949661,0.3823814133591481,5
122704,293,374,534,1201,122704,0.24396336386344714,0.31140716069941715,0.4446294754371357,5
122705,412,459,690,1561,122705,0.26393337604099937,0.29404228058936577,0.44202434336963486,6
122706,465,596,978,2039,122706,0.22805296714075526,0.29230014713094654,0.47964688572829817,6
122707,382,485,784,1651,122707,0.2313749242883101,0.29376135675348275,0.47486371895820717,6
122801,669,943,1224,2836,122801,0.2358956276445698,0.33251057827926656,0.4315937940761636,5
122802,569,680,1098,2347,122802,0.24243715381337877,0.2897315722198551,0.4678312739667661,6
122901,768,807,1530,3105,122901,0.24734299516908212,0.2599033816425121,0.4927536231884058,6
122902,534,720,1188,2442,122902,0.21867321867321868,0.29484029484029484,0.4864864864864865,6
123001,718,812,1455,2985,123001,0.240536013400335,0.2720268006700168,0.48743718592964824,6
123002,545,713,1183,2441,123002,0.22326915198689062,0.2920934043424826,0.4846374436706268,6
123101,449,477,979,1905,123101,0.2356955380577428,0.2503937007874016,0.5139107611548557,6
123102,446,561,1115,2122,123102,0.21017907634307256,0.264373232799246,0.5254476908576814,6
123201,270,545,410,1225,123201,0.22040816326530613,0.4448979591836735,0.3346938775510204,5
123202,1127,1657,1434,4218,123202,0.2671882408724514,0.39284020862968233,0.3399715504978663,5
123301,865,1346,1269,3480,123301,0.24856321839080459,0.3867816091954023,0.3646551724137931,5
123302,249,428,308,985,123302,0.25279187817258886,0.43451776649746193,0.31269035532994927,5
123401,548,755,985,2288,123401,0.2395104895104895,0.3299825174825175,0.430506993006993,5
123402,967,1225,1680,3872,123402,0.2497417355371901,0.31637396694214875,0.43388429752066116,5
123500,638,846,1168,2652,123500,0.24057315233785823,0.3190045248868778,0.44042232277526394,5
123600,419,455,989,1863,123600,0.22490606548577563,0.24422973698336017,0.5308641975308642,6
123700,919,620,499,2038,123700,0.45093228655544654,0.3042198233562316,0.2448478900883219,1
123701,829,1474,1093,3396,123701,0.24411071849234395,0.43404004711425204,0.321849234393404,5
123702,942,1417,1605,3964,123702,0.23763874873864782,0.35746720484359235,0.40489404641775983,5
123801,468,558,1090,2116,123801,0.22117202268431002,0.2637051039697543,0.5151228733459358,6
123802,392,466,841,1699,123802,0.2307239552678046,0.2742789876397881,0.4949970570924073,6
123900,648,779,1268,2695,123900,0.24044526901669758,0.28905380333951763,0.47050092764378476,6
124001,599,642,1224,2465,124001,0.24300202839756593,0.26044624746450307,0.496551724137931,6
124002,470,508,829,1807,124002,0.26009961261759823,0.2811289429994466,0.4587714443829552,6
124100,322,389,606,1317,124100,0.24449506454062261,0.2953682611996963,0.4601366742596811,6
124101,551,675,1117,2343,124101,0.23516858728126333,0.2880921895006402,0.4767392232180965,6
124102,453,444,917,1814,124102,0.24972436604189635,0.24476295479603086,0.5055126791620728,6
124200,787,867,1522,3176,124200,0.24779596977329973,0.2729848866498741,0.4792191435768262,6
124300,754,885,1734,3373,124300,0.223539875481767,0.2623777053068485,0.5140824192113845,6
124401,444,510,1002,1956,124401,0.22699386503067484,0.2607361963190184,0.5122699386503068,6
124402,451,495,970,1916,124402,0.23538622129436326,0.25835073068893527,0.5062630480167014,6
124500,613,638,1301,2552,124500,0.24020376175548588,0.25,0.5097962382445141,6
124601,310,368,856,1534,124601,0.20208604954367665,0.23989569752281617,0.5580182529335072,6
124602,443,500,1286,2229,124602,0.1987438313144908,0.2243158366980709,0.5769403319874383,6
124700,265,341,685,1291,124700,0.20526723470178157,0.2641363284275755,0.530596436870643,6
125700,231,373,506,1110,125700,0.20810810810810812,0.33603603603603605,0.45585585585585586,5
126500,173,205,346,724,126500,0.23895027624309392,0.28314917127071826,0.47790055248618785,6
126700,250,262,515,1027,126700,0.24342745861733203,0.25511197663096397,0.501460564751704,6
127700,264,362,740,1366,127700,0.19326500732064422,0.26500732064421667,0.541727672035139,6
128300,29,49,53,131,128300,0.22137404580152673,0.37404580152671757,0.40458015267175573,5
129102,276,287,698,1261,129102,0.21887390959555908,0.22759714512291832,0.5535289452815226,6
129103,272,324,774,1370,129103,0.19854014598540146,0.2364963503649635,0.564963503649635,6
129104,288,316,928,1532,129104,0.18798955613577023,0.206266318537859,0.6057441253263708,6
130003,634,694,1201,2529,130003,0.25069197311190194,0.27441676551996835,0.4748912613681297,6
130004,211,235,513,959,130004,0.22002085505735142,0.24504692387904067,0.5349322210636079,6
130005,347,364,680,1391,130005,0.24946081955427749,0.2616822429906542,0.4888569374550683,6
130100,291,398,783,1472,130100,0.19769021739130435,0.2703804347826087,0.5319293478260869,6
133300,311,361,728,1400,133300,0.22214285714285714,0.25785714285714284,0.52,6
133900,129,145,302,576,133900,0.22395833333333334,0.2517361111111111,0.5243055555555556,6
134100,290,350,628,1268,134100,0.22870662460567823,0.27602523659305994,0.4952681388012618,6
134700,711,906,1616,3233,134700,0.2199195793380761,0.28023507578100837,0.49984534488091553,6
134702,663,698,1673,3034,134702,0.21852340145023072,0.23005932762030323,0.551417270929466,6
134703,401,394,1113,1908,134703,0.21016771488469602,0.20649895178197064,0.5833333333333334,6
134704,259,293,743,1295,134704,0.2,0.22625482625482626,0.5737451737451738,6
134902,528,475,1432,2435,134902,0.21683778234086243,0.19507186858316222,0.5880903490759753,6
134903,149,110,384,643,134903,0.2317262830482115,0.17107309486780714,0.5972006220839814,6
134904,714,734,1857,3305,134904,0.21603630862329803,0.22208774583963692,0.5618759455370651,6
134906,602,595,1489,2686,134906,0.22412509307520476,0.22151898734177214,0.5543559195830231,6
134907,434,419,1204,2057,134907,0.21098687408847835,0.20369470102090423,0.5853184248906174,6
135002,603,625,1598,2826,135002,0.21337579617834396,0.22116065109695682,0.5654635527246992,6
135003,562,474,1495,2531,135003,0.2220466218885816,0.18727775582773606,0.5906756222836823,6
135004,315,334,971,1620,135004,0.19444444444444445,0.20617283950617285,0.5993827160493828,6
135005,332,325,829,1486,135005,0.2234185733512786,0.21870794078061911,0.5578734858681023,6
135101,493,431,1079,2003,135101,0.24613080379430854,0.21517723414877685,0.5386919620569146,6
135102,530,470,1338,2338,135102,0.22668947818648416,0.20102651839178784,0.572284003421728,6
135103,567,536,1360,2463,135103,0.23020706455542023,0.21762078765732845,0.5521721477872513,6
135104,581,547,1407,2535,135104,0.2291913214990138,0.21577909270216963,0.5550295857988166,6
135201,281,271,651,1203,135201,0.23358270989193683,0.22527015793848712,0.5411471321695761,6
135204,488,477,1232,2197,135204,0.2221210741920801,0.2171142467000455,0.5607646791078744,6
135205,559,504,1376,2439,135205,0.22919229192291923,0.2066420664206642,0.5641656416564166,6
135208,331,342,838,1511,135208,0.21906022501654535,0.22634017207147583,0.5545996029119789,6
135209,333,359,986,1678,135209,0.19845053635280097,0.21394517282479142,0.5876042908224076,6
135301,412,388,1130,1930,135301,0.21347150259067357,0.20103626943005182,0.5854922279792746,6
135303,450,450,1222,2122,135303,0.21206409048067862,0.21206409048067862,0.5758718190386428,6
135304,421,370,974,1765,135304,0.23852691218130312,0.2096317280453258,0.5518413597733711,6
135401,696,616,1786,3098,135401,0.22466107165913493,0.1988379599741769,0.5765009683666882,6
135402,836,697,2037,3570,135402,0.23417366946778712,0.19523809523809524,0.5705882352941176,6
135403,472,546,1350,2368,135403,0.19932432432432431,0.23057432432432431,0.5701013513513513,6
136700,454,507,1009,1970,136700,0.23045685279187816,0.25736040609137056,0.5121827411167512,6
137700,468,623,1119,2210,137700,0.21176470588235294,0.2819004524886878,0.5063348416289593,6
138501,339,492,775,1606,138501,0.21108343711083438,0.30635118306351183,0.4825653798256538,5
138502,22,43,43,108,138502,0.2037037037037037,0.39814814814814814,0.39814814814814814,5
139900,156,206,375,737,139900,0.21166892808683854,0.27951153324287653,0.508819538670285,6
140101,514,578,965,2057,140101,0.2498784637822071,0.2809917355371901,0.46912980068060284,6
140200,781,1015,1619,3415,140200,0.22869692532942898,0.2972181551976574,0.4740849194729136,6
140300,844,1083,1696,3623,140300,0.23295611371791333,0.2989235440242893,0.4681203422577974,6
140400,579,515,1378,2472,140400,0.2342233009708738,0.20833333333333334,0.5574433656957929,6
140500,307,320,628,1255,140500,0.2446215139442231,0.2549800796812749,0.500398406374502,6
140602,375,382,797,1554,140602,0.2413127413127413,0.24581724581724582,0.5128700128700129,6
140700,696,795,1623,3114,140700,0.22350674373795762,0.25529865125240847,0.5211946050096339,6
140801,333,353,623,1309,140801,0.25439266615737205,0.2696715049656226,0.47593582887700536,6
140901,95,128,211,434,140901,0.21889400921658986,0.29493087557603687,0.4861751152073733,6
140902,222,234,488,944,140902,0.23516949152542374,0.2478813559322034,0.5169491525423728,6
141700,332,459,816,1607,141700,0.20659614187927816,0.28562538892345984,0.507778469197262,6
142900,318,344,682,1344,142900,0.23660714285714285,0.25595238095238093,0.5074404761904762,6
143500,183,236,407,826,143500,0.2215496368038741,0.2857142857142857,0.4927360774818402,6
144100,252,321,581,1154,144100,0.21837088388214904,0.2781629116117851,0.5034662045060658,6
144700,267,316,491,1074,144700,0.24860335195530725,0.2942271880819367,0.45716945996275604,6
145101,110,135,247,492,145101,0.22357723577235772,0.27439024390243905,0.5020325203252033,6
145102,236,254,425,915,145102,0.25792349726775954,0.27759562841530055,0.4644808743169399,6
145602,634,1475,927,3036,145602,0.2088274044795784,0.485836627140975,0.30533596837944665,5
145603,645,1421,890,2956,145603,0.2182002706359946,0.4807171853856563,0.3010825439783491,5
145604,508,1032,669,2209,145604,0.22996831145314622,0.46717971933001357,0.3028519692168402,5
145605,432,865,523,1820,145605,0.23736263736263735,0.47527472527472525,0.28736263736263734,4
145701,614,664,1481,2759,145701,0.22254440014498006,0.24066690830010873,0.5367886915549112,6
145702,676,1291,879,2846,145702,0.23752635277582573,0.45361911454673226,0.308854532677442,5
145703,626,1128,932,2686,145703,0.233060312732688,0.4199553239017126,0.3469843633655994,5
145704,883,1376,1304,3563,145704,0.24782486668537748,0.3861914117316868,0.36598372158293574,5
145803,484,547,1328,2359,145803,0.20517168291649004,0.23187791437049599,0.562950402713014,6
145804,431,587,758,1776,145804,0.24268018018018017,0.330518018018018,0.42680180180180183,5
145805,729,841,1613,3183,145805,0.2290292177191329,0.26421614828777884,0.5067546339930883,6
145807,549,580,1213,2342,145807,0.23441502988898377,0.24765157984628522,0.517933390264731,6
145808,423,457,807,1687,145808,0.25074096028452875,0.2708950800237107,0.47836395969176054,6
145900,218,252,529,999,145900,0.2182182182182182,0.25225225225225223,0.5295295295295295,6
145901,383,604,652,1639,145901,0.2336790726052471,0.3685173886516168,0.39780353874313606,5
145902,912,1734,1309,3955,145902,0.23059418457648545,0.4384323640960809,0.3309734513274336,5
145903,689,892,1470,3051,145903,0.22582759750901343,0.2923631596197968,0.48180924287118976,6
146001,511,1069,678,2258,146001,0.2263064658990257,0.4734278122232064,0.30026572187776795,5
146002,580,1141,779,2500,146002,0.232,0.4564,0.3116,5
146003,905,1302,1650,3857,146003,0.23463831993777548,0.33756805807622503,0.42779362198599946,5
146102,344,550,409,1303,146102,0.2640061396776669,0.42210283960092093,0.3138910207214121,5
146103,504,587,1111,2202,146103,0.22888283378746593,0.26657584014532243,0.5045413260672116,6
146105,788,1432,927,3147,146105,0.25039720368605023,0.45503654273911665,0.2945662535748332,4
146106,562,921,695,2178,146106,0.2580348943985308,0.4228650137741047,0.31910009182736454,5
146201,535,1075,753,2363,146201,0.2264071096064325,0.4549301735082522,0.3186627168853153,5
146202,580,1040,685,2305,146202,0.25162689804772237,0.4511930585683297,0.29718004338394793,4
146203,651,1155,876,2682,146203,0.24272930648769575,0.4306487695749441,0.32662192393736017,5
146204,668,1395,987,3050,146204,0.21901639344262294,0.45737704918032784,0.3236065573770492,5
146205,296,356,622,1274,146205,0.23233908948194662,0.2794348508634223,0.48822605965463106,6
146206,284,399,567,1250,146206,0.2272,0.3192,0.4536,5
146300,449,590,961,2000,146300,0.2245,0.295,0.4805,6
146402,540,689,1145,2374,146402,0.22746419545071608,0.2902274641954507,0.4823083403538332,6
146403,571,972,811,2354,146403,0.2425658453695837,0.4129141886151232,0.3445199660152931,5
146404,390,695,612,1697,146404,0.22981732469063051,0.40954625810253387,0.3606364172068356,5
146500,645,770,1426,2841,146500,0.22703273495248152,0.27103132699753607,0.5019359380499824,6
146604,550,674,1399,2623,146604,0.20968356843309188,0.2569576820434617,0.5333587495234464,6
146605,169,183,309,661,146605,0.2556732223903177,0.27685325264750377,0.46747352496217853,6
146606,858,936,2098,3892,146606,0.22045220966084275,0.24049331963001028,0.5390544707091469,6
146607,307,431,722,1460,146607,0.21027397260273972,0.2952054794520548,0.4945205479452055,6
146608,294,349,804,1447,146608,0.20317899101589496,0.24118866620594334,0.5556323427781618,6
146611,342,450,1004,1796,146611,0.19042316258351893,0.2505567928730512,0.5590200445434298,6
146612,563,675,1425,2663,146612,0.21141569658280135,0.2534735260983853,0.5351107773188134,6
146613,476,533,1026,2035,146613,0.2339066339066339,0.2619164619164619,0.5041769041769042,6
146614,612,725,1743,3080,146614,0.1987012987012987,0.2353896103896104,0.5659090909090909,6
146615,547,618,1445,2610,146615,0.2095785440613027,0.2367816091954023,0.553639846743295,6
146700,209,249,491,949,146700,0.220231822971549,0.2623814541622761,0.5173867228661749,6
146703,541,720,813,2074,146703,0.2608486017357763,0.3471552555448409,0.3919961427193828,5
146704,298,255,578,1131,146704,0.2634836427939876,0.22546419098143236,0.51105216622458,6
146705,368,392,1015,1775,146705,0.20732394366197182,0.2208450704225352,0.571830985915493,6
146706,337,405,779,1521,146706,0.2215647600262985,0.26627218934911245,0.5121630506245891,6
146800,728,774,1689,3191,146800,0.22814164838608586,0.2425571921027891,0.529301159511125,6
146901,661,712,1529,2902,146901,0.22777394900068917,0.24534803583735354,0.5268780151619573,6
146902,446,451,1153,2050,146902,0.2175609756097561,0.22,0.562439024390244,6
147001,542,555,1228,2325,147001,0.23311827956989248,0.23870967741935484,0.5281720430107527,6
147003,445,584,1298,2327,147003,0.19123334765792865,0.2509669101847873,0.557799742157284,6
147004,54,69,89,212,147004,0.25471698113207547,0.32547169811320753,0.419811320754717,5
147100,540,701,1472,2713,147100,0.19904165130851456,0.2583855510504976,0.5425727976409879,6
147200,688,860,1406,2954,147200,0.23290453622207177,0.2911306702775897,0.47596479350033855,6
147300,736,1038,1488,3262,147300,0.22562844880441446,0.31820968730839977,0.45616186388718577,5
147401,716,895,1613,3224,147401,0.22208436724565755,0.27760545905707196,0.5003101736972705,6
147402,439,464,1143,2046,147402,0.21456500488758554,0.22678396871945258,0.5586510263929618,6
147501,892,962,2163,4017,147501,0.22205626089121236,0.23948220064724918,0.5384615384615384,6
147502,805,925,1918,3648,147502,0.2206688596491228,0.25356359649122806,0.5257675438596491,6
147503,207,226,562,995,147503,0.20804020100502513,0.2271356783919598,0.5648241206030151,6
147601,278,279,752,1309,147601,0.21237585943468296,0.2131398013750955,0.5744843391902216,6
147602,580,625,1443,2648,147602,0.2190332326283988,0.23602719033232628,0.5449395770392749,6
147701,422,445,1020,1887,147701,0.22363540010598834,0.23582405935347112,0.5405405405405406,6
147702,602,646,1414,2662,147702,0.2261457550713749,0.24267468069120962,0.5311795642374155,6
147802,425,463,1136,2024,147802,0.2099802371541502,0.22875494071146246,0.5612648221343873,6
147803,333,402,843,1578,147803,0.21102661596958175,0.25475285171102663,0.5342205323193916,6
147804,685,677,1690,3052,147804,0.2244429882044561,0.22182175622542594,0.5537352555701179,6
147900,313,410,774,1497,147900,0.20908483633934535,0.2738810955243821,0.5170340681362725,6
147901,488,601,1310,2399,147901,0.20341809087119633,0.25052105043768236,0.5460608586911213,6
147902,505,508,1300,2313,147902,0.21833117163856464,0.21962818849978383,0.5620406398616515,6
148300,222,267,611,1100,148300,0.2018181818181818,0.24272727272727274,0.5554545454545454,6
150003,281,250,485,1016,150003,0.2765748031496063,0.24606299212598426,0.47736220472440943,6
150004,408,442,879,1729,150004,0.23597455176402546,0.2556390977443609,0.5083863504916136,6
150005,298,360,610,1268,150005,0.23501577287066247,0.28391167192429023,0.4810725552050473,6
150006,226,244,485,955,150006,0.23664921465968586,0.2554973821989529,0.5078534031413613,6
150100,626,771,575,1972,150100,0.3174442190669371,0.390973630831643,0.29158215010141986,1
150200,943,1095,1393,3431,150200,0.2748469833867677,0.3191489361702128,0.40600408044301955,5
150300,554,705,617,1876,150300,0.2953091684434968,0.3757995735607676,0.3288912579957356,5
150400,416,447,441,1304,150400,0.31901840490797545,0.3427914110429448,0.33819018404907975,3
150500,481,538,530,1549,150500,0.3105229180116204,0.3473208521626856,0.342156229825694,3
150701,228,251,587,1066,150701,0.21388367729831145,0.2354596622889306,0.550656660412758,6
150702,228,298,619,1145,150702,0.19912663755458515,0.26026200873362443,0.5406113537117904,6
152200,300,467,766,1533,152200,0.19569471624266144,0.30463144161774297,0.49967384213959554,5
152901,457,548,1149,2154,152901,0.21216341689879295,0.25441039925719594,0.5334261838440112,6
152902,316,476,963,1755,152902,0.18005698005698006,0.2712250712250712,0.5487179487179488,6
155101,142,220,321,683,155101,0.20790629575402636,0.32210834553440704,0.4699853587115666,5
155102,576,816,1678,3070,155102,0.18762214983713354,0.26579804560260584,0.5465798045602606,6
156700,149,148,247,544,156700,0.27389705882352944,0.27205882352941174,0.4540441176470588,6
157101,561,782,1443,2786,157101,0.20136396267049533,0.28068916008614503,0.5179468772433596,6
157102,158,267,374,799,157102,0.19774718397997496,0.3341677096370463,0.46808510638297873,5
157901,422,550,987,1959,157901,0.21541602858601328,0.28075548749361917,0.5038284839203675,6
157902,390,469,737,1596,157902,0.24436090225563908,0.29385964912280704,0.4617794486215539,6
157903,443,554,851,1848,157903,0.23971861471861472,0.29978354978354976,0.4604978354978355,6
158001,463,437,1357,2257,158001,0.2051395657953035,0.19361984935755427,0.6012405848471423,6
158002,559,564,1653,2776,158002,0.20136887608069165,0.20317002881844382,0.5954610951008645,6
158006,694,704,1713,3111,158006,0.2230793956927033,0.2262937962070074,0.5506268081002893,6
158007,402,474,963,1839,158007,0.21859706362153344,0.25774877650897227,0.5236541598694943,6
158009,252,242,779,1273,158009,0.19795758051846032,0.19010212097407697,0.6119402985074627,6
158010,358,357,1047,1762,158010,0.20317820658342792,0.2026106696935301,0.594211123723042,6
158011,463,527,1255,2245,158011,0.20623608017817371,0.23474387527839644,0.5590200445434298,6
158102,640,737,1227,2604,158102,0.2457757296466974,0.28302611367127495,0.47119815668202764,6
158103,534,644,1106,2284,158103,0.23380035026269702,0.2819614711033275,0.4842381786339755,6
158104,693,823,1420,2936,158104,0.23603542234332425,0.2803133514986376,0.48365122615803813,6
158107,427,502,1035,1964,158107,0.2174134419551935,0.2556008146639511,0.5269857433808554,6
158108,339,389,840,1568,158108,0.21619897959183673,0.24808673469387754,0.5357142857142857,6
158110,472,557,941,1970,158110,0.23959390862944163,0.28274111675126906,0.47766497461928936,6
158111,407,482,836,1725,158111,0.23594202898550726,0.27942028985507245,0.4846376811594203,6
158112,568,664,1042,2274,158112,0.2497801231310466,0.29199648197009676,0.45822339489885666,6
158114,459,500,954,1913,158114,0.23993727130162049,0.26136957658128596,0.4986931521170936,6
158115,740,785,1693,3218,158115,0.22995649471721566,0.24394033561218148,0.5261031696706029,6
158116,246,299,503,1048,158116,0.23473282442748092,0.28530534351145037,0.4799618320610687,6
158202,879,931,1862,3672,158202,0.23937908496732027,0.25354030501089325,0.5070806100217865,6
158203,165,173,450,788,158203,0.20939086294416243,0.21954314720812182,0.5710659898477157,6
158205,178,216,553,947,158205,0.18796198521647306,0.22808870116156282,0.5839493136219641,6
158206,418,436,973,1827,158206,0.2287903667214012,0.23864258347016967,0.5325670498084292,6
158207,496,493,1264,2253,158207,0.2201509098979139,0.21881935197514424,0.5610297381269419,6
158304,732,775,1864,3371,158304,0.21714624740433106,0.22990210619994067,0.5529516463957282,6
158306,698,647,1616,2961,158306,0.23573117190138468,0.21850726106045254,0.5457615670381628,6
158308,1105,1202,2022,4329,158308,0.2552552552552553,0.2776622776622777,0.4670824670824671,6
158309,476,704,1041,2221,158309,0.21431787483115713,0.3169743358847366,0.4687077892841063,5
158310,503,516,994,2013,158310,0.24987580725285644,0.2563338301043219,0.49379036264282167,6
158315,522,717,1161,2400,158315,0.2175,0.29875,0.48375,6
158317,594,743,1472,2809,158317,0.2114631541473834,0.2645069419722321,0.5240299038803845,6
158318,534,528,1240,2302,158318,0.2319721980886186,0.22936576889661164,0.5386620330147698,6
158319,480,485,912,1877,158319,0.2557272242940863,0.2583910495471497,0.48588172615876396,6
158320,769,859,1647,3275,158320,0.23480916030534352,0.26229007633587786,0.5029007633587786,6
158321,960,1213,2200,4373,158321,0.21952892750971872,0.27738394694717583,0.5030871255431054,6
158322,188,200,491,879,158322,0.21387940841865757,0.22753128555176336,0.558589306029579,6
158323,731,826,1932,3489,158323,0.20951562052163944,0.23674405273717397,0.5537403267411866,6
158401,151,147,382,680,158401,0.22205882352941175,0.2161764705882353,0.5617647058823529,6
158402,470,445,1272,2187,158402,0.21490626428898033,0.2034750800182899,0.5816186556927297,6
158403,294,336,617,1247,158403,0.23576583801122694,0.2694466720128308,0.49478748997594224,6
158405,563,635,1345,2543,158405,0.22139205662603226,0.24970507274872197,0.5289028706252458,6
158407,654,724,1574,2952,158407,0.22154471544715448,0.24525745257452575,0.5331978319783198,6
158408,479,528,997,2004,158408,0.23902195608782434,0.2634730538922156,0.49750499001996007,6
158409,380,522,963,1865,158409,0.2037533512064343,0.27989276139410185,0.5163538873994639,6
158410,304,258,591,1153,158410,0.26366001734605377,0.22376409366869038,0.5125758889852559,6
158502,437,520,855,1812,158502,0.24116997792494482,0.2869757174392936,0.4718543046357616,6
158505,491,546,1089,2126,158505,0.23095014111006584,0.2568203198494826,0.5122295390404515,6
158506,312,397,676,1385,158506,0.2252707581227437,0.28664259927797836,0.488086642599278,6
158507,512,558,998,2068,158507,0.24758220502901354,0.269825918762089,0.4825918762088975,6
158508,694,834,1569,3097,158508,0.22408782692928642,0.2692928640619955,0.5066193090087181,6
158509,576,754,1153,2483,158509,0.2319774466371325,0.3036649214659686,0.46435763189689894,5
158510,803,1069,1858,3730,158510,0.21528150134048257,0.28659517426273456,0.49812332439678286,6
158511,696,890,1492,3078,158511,0.22612085769980506,0.28914879792072773,0.48473034437946716,6
158512,408,443,907,1758,158512,0.23208191126279865,0.25199089874857794,0.5159271899886234,6
158604,578,693,1315,2586,158604,0.22351121423047177,0.2679814385150812,0.508507347254447,6
158605,540,723,1208,2471,158605,0.21853500607041684,0.292594091460947,0.4888709024686362,6
158606,618,699,1283,2600,158606,0.2376923076923077,0.26884615384615385,0.49346153846153845,6
158607,318,494,849,1661,158607,0.19145093317278747,0.29741119807344973,0.5111378687537628,6
158608,501,590,956,2047,158608,0.24474841231069858,0.2882266731802638,0.4670249145090376,6
158609,532,635,1110,2277,158609,0.23364075537988582,0.27887571365832237,0.4874835309617918,6
158704,851,1147,1800,3798,158704,0.22406529752501317,0.3020010531858873,0.47393364928909953,5
158705,444,594,756,1794,158705,0.24749163879598662,0.3311036789297659,0.4214046822742475,5
158707,191,269,486,946,158707,0.20190274841437633,0.2843551797040169,0.5137420718816068,6
158708,437,574,880,1891,158708,0.2310946589106293,0.30354309888947645,0.46536224219989425,5
158709,226,343,601,1170,158709,0.19316239316239317,0.2931623931623932,0.5136752136752136,6
158710,460,581,930,1971,158710,0.23338406900050734,0.2947742262810756,0.471841704718417,6
158711,589,655,1202,2446,158711,0.24080130825838103,0.26778413736713,0.49141455437448894,6
158712,841,1081,1723,3645,158712,0.23072702331961592,0.29657064471879285,0.4727023319615912,6
158802,548,579,1487,2614,158802,0.20964039785768937,0.22149961744452945,0.5688599846977812,6
158803,755,903,1614,3272,158803,0.23074572127139364,0.27597799511002447,0.4932762836185819,6
158804,852,1092,1696,3640,158804,0.23406593406593407,0.3,0.46593406593406594,5
158900,778,1051,1521,3350,158900,0.23223880597014926,0.3137313432835821,0.45402985074626867,5
159000,520,656,1007,2183,159000,0.23820430600091616,0.3005038937242327,0.4612918002748511,5
159102,742,948,1486,3176,159102,0.2336272040302267,0.29848866498740556,0.46788413098236775,6
159103,671,1075,929,2675,159103,0.2508411214953271,0.40186915887850466,0.3472897196261682,5
159105,801,1156,1628,3585,159105,0.22343096234309623,0.3224546722454672,0.4541143654114365,5
159106,640,967,1441,3048,159106,0.2099737532808399,0.317257217847769,0.47276902887139105,5
159107,490,547,947,1984,159107,0.2469758064516129,0.2757056451612903,0.47731854838709675,6
159108,841,1074,1815,3730,159108,0.2254691689008043,0.2879356568364611,0.4865951742627346,6
159201,334,435,714,1483,159201,0.22521915037086987,0.2933243425488874,0.48145650708024273,6
159203,590,699,1467,2756,159203,0.21407837445573294,0.25362844702467346,0.5322931785195936,6
159204,442,517,1030,1989,159204,0.2222222222222222,0.25992961287078936,0.5178481649069885,6
159300,240,237,578,1055,159300,0.22748815165876776,0.22464454976303316,0.547867298578199,6
159404,828,1133,1524,3485,159404,0.2375896700143472,0.32510760401721667,0.43730272596843617,5
159406,485,590,1010,2085,159406,0.23261390887290168,0.2829736211031175,0.4844124700239808,6
159407,734,993,1442,3169,159407,0.23161880719469866,0.3133480593247081,0.45503313348059327,5
159408,487,678,915,2080,159408,0.23413461538461539,0.32596153846153847,0.43990384615384615,5
159410,817,970,2017,3804,159410,0.2147739221871714,0.25499474237644587,0.5302313354363828,6
159411,385,531,928,1844,159411,0.20878524945770066,0.28796095444685466,0.5032537960954447,6
159412,845,986,2005,3836,159412,0.220281543274244,0.2570385818561001,0.5226798748696558,6
159505,867,1245,1780,3892,159505,0.22276464542651592,0.3198869475847893,0.4573484069886948,5
159506,1024,1388,1751,4163,159506,0.24597645928417006,0.3334134037953399,0.42061013692049004,5
159508,762,1115,1485,3362,159508,0.22665080309339677,0.3316478286734087,0.4417013682331945,5
159509,340,439,537,1316,159509,0.25835866261398177,0.33358662613981765,0.40805471124620063,5
159510,56,46,67,169,159510,0.33136094674556216,0.27218934911242604,0.39644970414201186,2
159511,761,1130,1312,3203,159511,0.23758975960037465,0.352794255385576,0.40961598501404933,5
159512,284,342,526,1152,159512,0.2465277777777778,0.296875,0.4565972222222222,6
159601,692,821,1632,3145,159601,0.22003179650238475,0.26104928457869636,0.518918918918919,6
159602,499,544,1151,2194,159602,0.22743846855059252,0.2479489516864175,0.52461257976299,6
160003,220,276,427,923,160003,0.23835319609967498,0.2990249187432286,0.4626218851570964,6
160004,220,288,590,1098,160004,0.20036429872495445,0.26229508196721313,0.5373406193078324,6
160005,274,303,621,1198,160005,0.2287145242070117,0.25292153589315525,0.5183639398998331,6
161700,422,479,970,1871,161700,0.2255478353821486,0.25601282736504544,0.518439337252806,6
162100,475,731,1099,2305,162100,0.20607375271149675,0.31713665943600866,0.4767895878524946,5
169701,813,907,1996,3716,169701,0.21878363832077502,0.24407965554359526,0.5371367061356297,6
169703,215,260,513,988,169703,0.21761133603238866,0.2631578947368421,0.5192307692307693,6
169704,724,940,1436,3100,169704,0.2335483870967742,0.3032258064516129,0.4632258064516129,5
169800,686,1051,1129,2866,169800,0.23935799023028612,0.3667131891137474,0.3939288206559665,5
169901,631,784,1111,2526,169901,0.24980205859065716,0.3103721298495645,0.4398258115597783,5
169902,475,544,944,1963,169902,0.24197656647987772,0.27712684666327053,0.48089658685685177,6
170000,380,460,752,1592,170000,0.23869346733668342,0.2889447236180904,0.4723618090452261,6
170001,614,792,1364,2770,170001,0.2216606498194946,0.28592057761732853,0.4924187725631769,6
170002,463,590,1011,2064,170002,0.2243217054263566,0.2858527131782946,0.4898255813953488,6
170101,268,345,429,1042,170101,0.2571976967370441,0.3310940499040307,0.41170825335892514,5
170201,654,719,1344,2717,170201,0.24070666175929334,0.2646301067353699,0.49466323150533675,6
170202,425,532,836,1793,170202,0.23703290574456218,0.2967094255437814,0.4662576687116564,6
180001,475,498,1059,2032,180001,0.23375984251968504,0.24507874015748032,0.5211614173228346,6
180300,409,509,889,1807,180300,0.2263420033204206,0.28168234643054785,0.49197565024903156,6
190101,453,491,902,1846,190101,0.24539544962080173,0.2659804983748646,0.4886240520043337,6
190102,235,230,471,936,190102,0.25106837606837606,0.24572649572649571,0.5032051282051282,6
190203,288,334,538,1160,190203,0.2482758620689655,0.28793103448275864,0.46379310344827585,6
190204,553,673,1155,2381,190204,0.23225535489290214,0.28265434691306174,0.4850902981940361,6
190301,352,492,767,1611,190301,0.21849782743637491,0.3054003724394786,0.4761018001241465,5
190401,1125,1369,1902,4396,190401,0.2559144676979072,0.3114194722474977,0.43266606005459507,5
190402,679,779,1305,2763,190402,0.24574737604053565,0.2819399203764025,0.4723127035830619,6
190403,398,506,735,1639,190403,0.24283099450884685,0.3087248322147651,0.448444173276388,5
190502,286,338,608,1232,190502,0.23214285714285715,0.27435064935064934,0.4935064935064935,6
190503,302,373,676,1351,190503,0.22353811991117692,0.27609178386380456,0.5003700962250185,6
190504,177,247,460,884,190504,0.2002262443438914,0.27941176470588236,0.5203619909502263,6
190601,480,562,1049,2091,190601,0.22955523672883787,0.2687709230033477,0.5016738402678145,6
190603,482,593,976,2051,190603,0.23500731350560702,0.28912725499756214,0.4758654314968308,6
190604,437,616,1002,2055,190604,0.21265206812652068,0.2997566909975669,0.48759124087591244,6
190704,274,364,539,1177,190704,0.23279524214103653,0.3092608326253186,0.45794392523364486,5
190705,364,466,748,1578,190705,0.23067173637515842,0.2953105196451204,0.4740177439797212,6
190706,454,630,1062,2146,190706,0.21155638397017706,0.293569431500466,0.49487418452935694,6
190707,426,603,1098,2127,190707,0.2002820874471086,0.2834978843441467,0.5162200282087447,6
190708,196,302,418,916,190708,0.21397379912663755,0.3296943231441048,0.45633187772925765,5
190800,312,316,629,1257,190800,0.24821002386634844,0.25139220365950676,0.5003977724741447,6
200001,350,427,686,1463,200001,0.23923444976076555,0.291866028708134,0.4688995215311005,6
200002,190,246,350,786,200002,0.24173027989821882,0.31297709923664124,0.44529262086513993,5
200901,133,171,265,569,200901,0.23374340949033393,0.30052724077328646,0.46572934973637964,5
200902,665,932,1501,3098,200902,0.21465461588121368,0.3008392511297611,0.4845061329890252,5
201001,559,862,1345,2766,201001,0.20209689081706436,0.3116413593637021,0.48626174981923354,5
201003,377,519,801,1697,201003,0.22215674720094283,0.30583382439599294,0.47200942840306426,5
201004,382,545,687,1614,201004,0.23667905824039653,0.33767038413878564,0.4256505576208178,5
201100,777,1265,987,3029,201100,0.25652030373060414,0.41762958071970946,0.32585011554968635,5
210101,559,658,920,2137,210101,0.26158165652784277,0.3079082826392138,0.43051006083294335,5
210201,450,577,725,1752,210201,0.2568493150684932,0.329337899543379,0.4138127853881279,5
210301,426,521,895,1842,210301,0.23127035830618892,0.28284473398479915,0.48588490770901194,6
220100,477,667,808,1952,220100,0.24436475409836064,0.3417008196721312,0.4139344262295082,5
220201,375,463,509,1347,220201,0.27839643652561247,0.3437268002969562,0.37787676317743135,5
220300,574,660,640,1874,220300,0.3062966915688367,0.35218783351120597,0.3415154749199573,3
220700,276,420,432,1128,220700,0.24468085106382978,0.3723404255319149,0.3829787234042553,5
220801,407,490,745,1642,220801,0.24786845310596833,0.2984165651644336,0.45371498172959807,6
220901,473,591,824,1888,220901,0.2505296610169492,0.3130296610169492,0.4364406779661017,5
221001,384,481,1053,1918,221001,0.20020855057351408,0.2507820646506778,0.5490093847758082,6
221100,399,447,500,1346,221100,0.2964338781575037,0.33209509658246655,0.37147102526002973,5
300000,603,795,1093,2491,300000,0.24207145724608592,0.3191489361702128,0.4387796065837013,5
300100,308,357,1114,1779,300100,0.1731309724564362,0.20067453625632378,0.62619449128724,6
300300,379,394,1043,1816,300300,0.20870044052863437,0.21696035242290748,0.5743392070484582,6
300400,432,439,1243,2114,300400,0.2043519394512772,0.2076631977294229,0.5879848628193,6
300500,429,437,1275,2141,300500,0.20037365716954694,0.20411022886501634,0.5955161139654367,6
300600,485,576,1732,2793,300600,0.1736484067311135,0.20622986036519872,0.6201217329036878,6
300700,441,566,1645,2652,300700,0.166289592760181,0.21342383107088989,0.6202865761689291,6
300800,343,476,1234,2053,300800,0.16707257671699952,0.23185582075012176,0.6010716025328787,6
300900,590,694,2238,3522,300900,0.16751845542305507,0.1970471323111868,0.6354344122657581,6
301000,358,380,1377,2115,301000,0.16926713947990543,0.17966903073286053,0.6510638297872341,6
301101,596,799,1692,3087,301101,0.1930677032717849,0.2588273404599935,0.5481049562682215,6
301102,411,410,1246,2067,301102,0.1988388969521045,0.19835510401548137,0.6028059990324142,6
301200,477,503,1503,2483,301200,0.19210632299637534,0.20257752718485703,0.6053161498187676,6
301300,444,521,1160,2125,301300,0.20894117647058824,0.2451764705882353,0.5458823529411765,6
301400,183,182,634,999,301400,0.1831831831831832,0.18218218218218218,0.6346346346346347,6
301500,247,239,770,1256,301500,0.19665605095541402,0.19028662420382167,0.6130573248407644,6
301600,326,395,1231,1952,301600,0.16700819672131148,0.2023565573770492,0.6306352459016393,6
301700,206,197,720,1123,301700,0.1834372217275156,0.17542297417631345,0.641139804096171,6
301800,475,570,1365,2410,301800,0.1970954356846473,0.23651452282157676,0.5663900414937759,6
301900,215,269,809,1293,301900,0.1662799690641918,0.20804331013147717,0.625676720804331,6
302000,408,441,1506,2355,302000,0.1732484076433121,0.18726114649681527,0.6394904458598726,6
302101,291,331,1126,1748,302101,0.16647597254004576,0.18935926773455378,0.6441647597254004,6
302102,306,301,970,1577,302102,0.19403931515535827,0.19086873811033608,0.6150919467343057,6
302200,404,485,1189,2078,302200,0.1944177093358999,0.23339749759384024,0.5721847930702598,6
302300,451,497,1335,2283,302300,0.19754708716600963,0.21769601401664476,0.5847568988173456,6
302400,520,612,1476,2608,302400,0.19938650306748465,0.23466257668711657,0.5659509202453987,6
302501,217,276,766,1259,302501,0.17235901509134233,0.2192216044479746,0.6084193804606831,6
302502,210,246,794,1250,302502,0.168,0.1968,0.6352,6
302600,258,290,666,1214,302600,0.21252059308072488,0.23887973640856672,0.5485996705107083,6
302700,425,533,1305,2263,302700,0.18780380026513477,0.23552806009721608,0.5766681396376492,6
302800,617,699,1742,3058,302800,0.20176586003924132,0.22858077174623936,0.5696533682145193,6
302900,441,540,1242,2223,302900,0.19838056680161945,0.242914979757085,0.5587044534412956,6
303000,587,685,1579,2851,303000,0.20589266923886357,0.2402665731322343,0.5538407576289022,6
303101,331,371,981,1683,303101,0.19667260843731432,0.22043969102792632,0.5828877005347594,6
303102,408,498,1201,2107,303102,0.19364024679639297,0.23635500711912671,0.5700047460844803,6
303201,408,461,1102,1971,303201,0.2070015220700152,0.23389142567224758,0.5591070522577372,6
303202,396,508,1106,2010,303202,0.19701492537313434,0.2527363184079602,0.5502487562189055,6
303301,327,389,947,1663,303301,0.19663259170174383,0.2339146121467228,0.5694527961515333,6
303302,493,492,1286,2271,303302,0.2170849845882871,0.2166446499339498,0.5662703654777631,6
303400,276,251,787,1314,303400,0.2100456621004566,0.19101978691019786,0.5989345509893456,6
303500,542,667,1500,2709,303500,0.20007382798080472,0.24621631598375784,0.5537098560354374,6
303600,691,918,2009,3618,303600,0.1909894969596462,0.2537313432835821,0.5552791597567717,6
303700,739,912,2059,3710,303700,0.19919137466307277,0.24582210242587602,0.5549865229110512,6
303800,585,697,1517,2799,303800,0.2090032154340836,0.24901750625223293,0.5419792783136834,6
303900,468,602,1132,2202,303900,0.2125340599455041,0.27338782924613986,0.5140781108083561,6
304001,272,367,795,1434,304001,0.1896792189679219,0.25592747559274753,0.5543933054393305,6
304002,482,640,1182,2304,304002,0.2092013888888889,0.2777777777777778,0.5130208333333334,6
304100,536,749,995,2280,304100,0.23508771929824562,0.3285087719298246,0.43640350877192985,5
304202,417,696,785,1898,304202,0.21970495258166492,0.3667017913593256,0.4135932560590095,5
304203,841,1325,1073,3239,304203,0.25964803951836984,0.4090768755788824,0.33127508490274776,5
304204,669,999,832,2500,304204,0.2676,0.3996,0.3328,5
401200,386,590,568,1544,401200,0.25,0.38212435233160624,0.36787564766839376,5
401300,509,896,827,2232,401300,0.22804659498207885,0.4014336917562724,0.37051971326164873,5
404300,378,411,860,1649,404300,0.22922983626440266,0.24924196482716798,0.5215281989084294,6
404400,498,485,1510,2493,404400,0.19975932611311673,0.1945447252306458,0.6056959486562374,6
404500,415,461,1160,2036,404500,0.2038310412573674,0.22642436149312378,0.5697445972495089,6
404600,427,463,1274,2164,404600,0.19731977818853974,0.21395563770794823,0.588724584103512,6
404700,563,709,1707,2979,404700,0.18898959382343067,0.2379993286337697,0.5730110775427996,6
404800,752,1038,1607,3397,404800,0.221371798645864,0.3055637327053282,0.47306446864880775,5
404901,538,1004,1357,2899,404901,0.18558123490858916,0.3463263194204898,0.468092445670921,5
404902,518,871,1093,2482,404902,0.20870265914585012,0.3509266720386785,0.4403706688154714,5
405000,559,892,1290,2741,405000,0.20394016782196278,0.3254286756658154,0.4706311565122218,5
405100,853,1220,2101,4174,405100,0.20436032582654529,0.2922855773838045,0.5033540967896503,6
405200,659,1006,1545,3210,405200,0.20529595015576324,0.3133956386292835,0.48130841121495327,5
405301,367,441,1005,1813,405301,0.202426916712631,0.24324324324324326,0.5543298400441258,6
405302,439,558,1280,2277,405302,0.19279754062362758,0.2450592885375494,0.562143170838823,6
405400,783,1053,2051,3887,405400,0.20144069976845896,0.2709030100334448,0.5276562901980962,6
405500,580,706,1633,2919,405500,0.1986981843096951,0.2418636519355944,0.5594381637547106,6
405600,432,514,1255,2201,405600,0.19627442071785553,0.2335302135393003,0.5701953657428441,6
405700,481,600,1406,2487,405700,0.19340570969039003,0.24125452352231605,0.5653397667872939,6
405800,464,418,1256,2138,405800,0.21702525724976612,0.19550982226379796,0.587464920486436,6
405900,574,687,1456,2717,405900,0.21126242178873758,0.2528524107471476,0.5358851674641149,6
406001,509,664,1266,2439,406001,0.2086920869208692,0.27224272242722425,0.5190651906519065,6
406002,395,437,868,1700,406002,0.2323529411764706,0.2570588235294118,0.5105882352941177,6
406100,388,441,844,1673,406100,0.2319187089061566,0.26359832635983266,0.5044829647340108,6
406201,358,488,875,1721,406201,0.20801859384079024,0.28355607205113303,0.5084253341080767,6
406202,682,956,1670,3308,406202,0.20616686819830712,0.2889963724304716,0.5048367593712213,6
406300,383,351,1057,1791,406300,0.2138470128419877,0.19597989949748743,0.5901730876605249,6
406400,560,578,1881,3019,406400,0.18549188473004305,0.19145412388208016,0.6230539913878768,6
406501,511,591,1950,3052,406501,0.16743119266055045,0.1936435124508519,0.6389252948885976,6
406600,355,347,1316,2018,406600,0.1759167492566898,0.17195242814667988,0.6521308225966304,6
406701,363,522,507,1392,406701,0.2607758620689655,0.375,0.3642241379310345,5
406702,503,693,784,1980,406702,0.25404040404040407,0.35,0.39595959595959596,5
406801,513,813,591,1917,406801,0.2676056338028169,0.4241001564945227,0.3082942097026604,5
406802,521,939,641,2101,406802,0.24797715373631604,0.4469300333174679,0.3050928129462161,5
406900,810,1220,991,3021,406900,0.26812313803376364,0.40383978814961935,0.328037073816617,5
407000,769,1239,1011,3019,407000,0.2547201059953627,0.41040079496522025,0.33487909903941704,5
407101,564,967,827,2358,407101,0.23918575063613232,0.4100932994062765,0.3507209499575912,5
407102,685,1040,940,2665,407102,0.2570356472795497,0.3902439024390244,0.3527204502814259,5
407201,524,852,597,1973,407201,0.26558540293968574,0.4318297009630005,0.30258489609731376,5
407203,396,614,549,1559,407203,0.25400898011545864,0.39384220654265556,0.3521488133418858,5
407204,294,473,501,1268,407204,0.23186119873817035,0.37302839116719244,0.3951104100946372,5
407301,437,582,888,1907,407301,0.2291557420031463,0.3051914001048768,0.4656528578919769,5
407302,573,987,905,2465,407302,0.23245436105476674,0.40040567951318456,0.3671399594320487,5
407401,770,1105,990,2865,407401,0.268760907504363,0.3856893542757417,0.34554973821989526,5
407402,421,686,657,1764,407402,0.23866213151927437,0.3888888888888889,0.37244897959183676,5
407501,627,1023,779,2429,407501,0.2581309180732812,0.4211609715932482,0.3207081103334706,5
407502,740,1073,930,2743,407502,0.26977761574917974,0.3911775428363106,0.33904484141450963,5
407600,601,749,1570,2920,407600,0.20582191780821918,0.2565068493150685,0.5376712328767124,6
407700,580,647,1363,2590,407700,0.22393822393822393,0.2498069498069498,0.5262548262548262,6
407801,583,727,1527,2837,407801,0.20549876630243213,0.2562566090941135,0.5382446246034543,6
407802,169,171,436,776,407802,0.21778350515463918,0.22036082474226804,0.5618556701030928,6
407900,515,553,1377,2445,407900,0.21063394683026584,0.2261758691206544,0.5631901840490797,6
408000,767,820,1899,3486,408000,0.2200229489386116,0.23522662076878945,0.544750430292599,6
408100,729,934,1963,3626,408100,0.20104798676227248,0.25758411472697185,0.5413678985107556,6
408200,802,1051,2038,3891,408200,0.2061166795168337,0.27011051143664866,0.5237728090465176,6
408300,807,1000,2030,3837,408300,0.21032056293979673,0.26062027625749284,0.5290591608027104,6
408400,474,468,1307,2249,408400,0.21076033792796797,0.20809248554913296,0.581147176522899,6
408500,677,716,1868,3261,408500,0.20760502913216805,0.2195645507513033,0.5728304201165286,6
408600,516,585,1277,2378,408600,0.21698906644238855,0.24600504625735914,0.5370058873002523,6
408700,550,692,1428,2670,408700,0.20599250936329588,0.2591760299625468,0.5348314606741573,6
408800,844,955,2032,3831,408800,0.2203080135734795,0.2492821717567215,0.530409814669799,6
408900,768,801,1667,3236,408900,0.2373300370828183,0.24752781211372063,0.515142150803461,6
409000,705,883,1663,3251,409000,0.2168563518917256,0.2716087357736081,0.5115349123346663,6
409100,622,758,1541,2921,409100,0.21294077370763437,0.2595001711742554,0.5275590551181102,6
409200,752,872,1868,3492,409200,0.21534936998854526,0.24971363115693013,0.5349369988545246,6
409300,501,581,1393,2475,409300,0.20242424242424242,0.23474747474747476,0.5628282828282828,6
409400,546,595,1301,2442,409400,0.22358722358722358,0.24365274365274364,0.5327600327600328,6
409500,484,442,1222,2148,409500,0.22532588454376165,0.20577281191806332,0.568901303538175,6
409600,601,608,1482,2691,409600,0.22333704942400595,0.22593831289483463,0.5507246376811594,6
409700,449,512,1290,2251,409700,0.19946690359840072,0.22745446468236338,0.5730786317192359,6
409800,523,882,1494,2899,409800,0.18040703690927906,0.3042428423594343,0.5153501207312866,5
409900,792,1091,2209,4092,409900,0.1935483870967742,0.2666177908113392,0.5398338220918866,6
410000,660,739,1490,2889,410000,0.2284527518172378,0.25579785392869503,0.5157493942540672,6
410100,596,682,1764,3042,410100,0.19592373438527286,0.22419460880999342,0.5798816568047337,6
410200,355,451,1101,1907,410200,0.18615626638699528,0.23649711588883063,0.5773466177241741,6
410300,727,889,1746,3362,410300,0.21624033313503865,0.26442593694229627,0.5193337299226651,6
410400,593,768,1381,2742,410400,0.2162654996353027,0.2800875273522976,0.5036469730123997,6
410500,687,1031,1835,3553,410500,0.1933577258654658,0.2901773149451168,0.5164649591894174,6
410600,701,1017,1880,3598,410600,0.19483046136742635,0.28265703168426903,0.5225125069483046,6
410700,751,949,1748,3448,410700,0.2178074245939675,0.27523201856148494,0.5069605568445475,6
410800,595,741,1421,2757,410800,0.21581429089590135,0.2687704026115343,0.5154153064925644,6
410900,532,699,1445,2676,410900,0.19880418535127056,0.26121076233183854,0.5399850523168909,6
411000,555,807,1124,2486,411000,0.2232502011263073,0.3246178600160901,0.45213193885760256,5
411100,501,673,897,2071,411100,0.24191211974891358,0.324963785610816,0.4331240946402704,5
411200,613,674,1482,2769,411200,0.2213795594077284,0.24340917298663778,0.5352112676056338,6
411301,331,394,913,1638,411301,0.20207570207570208,0.24053724053724054,0.5573870573870574,6
411302,499,545,1535,2579,411302,0.1934858472276076,0.2113222179139201,0.5951919348584723,6
411400,556,616,1536,2708,411400,0.20531757754800592,0.2274741506646972,0.5672082717872969,6
411500,240,267,832,1339,411500,0.17923823749066467,0.19940253920836445,0.6213592233009708,6
411600,490,536,1439,2465,411600,0.19878296146044624,0.21744421906693712,0.5837728194726166,6
411700,648,813,1717,3178,411700,0.2039018250471995,0.25582127123977344,0.5402769037130271,6
411800,649,877,1842,3368,411800,0.1926959619952494,0.2603919239904988,0.5469121140142518,6
411901,341,363,927,1631,411901,0.20907418761496016,0.22256284488044145,0.5683629675045984,6
411902,379,456,1058,1893,411902,0.20021130480718435,0.24088748019017434,0.5589012150026413,6
412000,662,833,1685,3180,412000,0.20817610062893083,0.2619496855345912,0.529874213836478,6
412100,610,688,1779,3077,412100,0.19824504387390315,0.2235944101397465,0.5781605459863504,6
412200,557,609,1532,2698,412200,0.20644922164566346,0.2257227575982209,0.5678280207561156,6
412301,333,389,1046,1768,412301,0.18834841628959276,0.22002262443438914,0.5916289592760181,6
412302,410,435,1032,1877,412302,0.2184336707511987,0.23175279701651572,0.5498135322322856,6
412400,570,625,1471,2666,412400,0.21380345086271568,0.23443360840210054,0.5517629407351838,6
412500,391,374,1251,2016,412500,0.1939484126984127,0.18551587301587302,0.6205357142857143,6
412600,290,296,1062,1648,412600,0.17597087378640777,0.1796116504854369,0.6444174757281553,6
412700,326,348,1135,1809,412700,0.18021006080707574,0.19237147595356552,0.6274184632393588,6
412800,364,417,984,1765,412800,0.20623229461756373,0.23626062322946176,0.5575070821529745,6
412900,634,939,1674,3247,412900,0.19525716045580535,0.28919002155836154,0.5155528179858331,6
413001,507,472,1191,2170,413001,0.23364055299539171,0.21751152073732719,0.5488479262672811,6
413002,416,461,1052,1929,413002,0.21565578019699327,0.23898392949714878,0.545360290305858,6
413100,544,617,1467,2628,413100,0.2070015220700152,0.234779299847793,0.5582191780821918,6
413200,755,753,1785,3293,413200,0.22927421803826298,0.22866686911630732,0.5420589128454297,6
413300,707,832,2147,3686,413300,0.1918068366793272,0.22571893651654912,0.5824742268041238,6
413400,557,649,1693,2899,413400,0.19213521904104863,0.22387030010348397,0.5839944808554675,6
413500,829,984,2049,3862,413500,0.21465561885033663,0.2547902641118591,0.5305541170378042,6
413600,605,799,1538,2942,413600,0.20564242012236575,0.2715839564921822,0.5227736233854521,6
413700,589,643,1490,2722,413700,0.21638501102130786,0.23622336517266715,0.547391623806025,6
413803,422,564,1184,2170,413803,0.19447004608294932,0.25990783410138246,0.5456221198156682,6
413804,451,510,1140,2101,413804,0.21465968586387435,0.2427415516420752,0.5425987624940505,6
413900,795,1252,1150,3197,413900,0.24867062871441978,0.39161714106975287,0.3597122302158273,5
414001,468,726,735,1929,414001,0.24261275272161742,0.37636080870917576,0.3810264385692068,5
414002,525,839,759,2123,414002,0.24729156853509185,0.3951954780970325,0.35751295336787564,5
414100,715,1125,1237,3077,414100,0.23236919077023074,0.3656158596035099,0.40201494962625933,5
414201,525,1021,777,2323,414201,0.22600086095566077,0.43951786482996125,0.33448127421437795,5
414202,548,882,672,2102,414202,0.26070409134157946,0.4196003805899144,0.3196955280685062,5
414301,459,608,593,1660,414301,0.2765060240963855,0.36626506024096384,0.3572289156626506,5
414303,534,762,869,2165,414303,0.24665127020785219,0.35196304849884524,0.40138568129330254,5
414304,454,764,506,1724,414304,0.2633410672853828,0.4431554524361949,0.29350348027842227,4
414400,599,923,820,2342,414400,0.2557643040136635,0.39410760034158837,0.35012809564474806,5
414501,572,824,1191,2587,414501,0.22110552763819097,0.31851565519907227,0.46037881716273676,5
414502,522,658,1103,2283,414502,0.22864651773981604,0.2882172579938677,0.48313622426631625,6
414600,400,471,1176,2047,414600,0.19540791402051783,0.23009281875915974,0.5744992672203224,6
414700,505,511,1438,2454,414700,0.20578647106764467,0.20823145884270577,0.5859820700896495,6
414800,776,841,1979,3596,414800,0.21579532814238042,0.23387096774193547,0.550333704115684,6
414900,837,781,2351,3969,414900,0.2108843537414966,0.19677500629881584,0.5923406399596876,6
415000,673,718,1859,3250,415000,0.20707692307692308,0.22092307692307692,0.572,6
415101,285,286,874,1445,415101,0.1972318339100346,0.19792387543252596,0.6048442906574395,6
415102,513,456,1626,2595,415102,0.1976878612716763,0.17572254335260115,0.6265895953757226,6
415201,410,357,1180,1947,415201,0.2105803800719055,0.18335901386748846,0.6060606060606061,6
415202,435,411,1407,2253,415202,0.19307589880159787,0.18242343541944075,0.6245006657789614,6
415300,714,674,1884,3272,415300,0.21821515892420537,0.20599022004889975,0.5757946210268948,6
415401,535,584,1661,2780,415401,0.19244604316546762,0.21007194244604316,0.5974820143884892,6
415402,474,523,1304,2301,415402,0.20599739243807041,0.22729248152976966,0.56671012603216,6
415500,341,326,818,1485,415500,0.22962962962962963,0.21952861952861952,0.5508417508417508,6
415600,566,623,1754,2943,415600,0.19232076112810056,0.21168875297315665,0.5959904858987428,6
415700,647,678,1961,3286,415700,0.19689592209373097,0.2063298843578819,0.5967741935483871,6
415802,760,687,2165,3612,415802,0.21040974529346623,0.19019933554817275,0.5993909191583611,6
416000,475,464,1206,2145,416000,0.22144522144522144,0.21631701631701633,0.5622377622377622,6
416100,704,753,1973,3430,416100,0.20524781341107873,0.219533527696793,0.5752186588921283,6
416201,399,476,1079,1954,416201,0.20419651995905835,0.2436028659160696,0.5522006141248721,6
416202,548,606,1197,2351,416202,0.23309230114844748,0.2577626541897065,0.5091450446618461,6
416300,323,381,1006,1710,416300,0.18888888888888888,0.22280701754385965,0.5883040935672514,6
416401,366,354,1011,1731,416401,0.21143847487001732,0.2045060658578856,0.584055459272097,6
416402,297,282,804,1383,416402,0.21475054229934923,0.2039045553145336,0.5813449023861171,6
416500,676,838,1306,2820,416500,0.2397163120567376,0.29716312056737587,0.4631205673758865,6
416600,429,486,1385,2300,416600,0.1865217391304348,0.21130434782608695,0.6021739130434782,6
416701,375,499,1058,1932,416701,0.19409937888198758,0.2582815734989648,0.5476190476190477,6
416702,318,425,1171,1914,416702,0.16614420062695925,0.2220480668756531,0.6118077324973876,6
416801,183,222,615,1020,416801,0.17941176470588235,0.21764705882352942,0.6029411764705882,6
416802,342,350,1074,1766,416802,0.19365798414496035,0.19818799546998866,0.608154020385051,6
416900,377,386,1189,1952,416900,0.19313524590163936,0.19774590163934427,0.6091188524590164,6
490100,330,454,410,1194,490100,0.27638190954773867,0.38023450586264657,0.34338358458961477,5
490200,324,410,587,1321,490200,0.24526873580620742,0.31037093111279335,0.44436033308099926,5
490300,457,640,687,1784,490300,0.2561659192825112,0.35874439461883406,0.3850896860986547,5
490400,283,363,539,1185,490400,0.23881856540084387,0.30632911392405066,0.4548523206751055,5
490500,399,451,534,1384,490500,0.28829479768786126,0.3258670520231214,0.38583815028901736,5
490600,394,530,595,1519,490600,0.2593811718235681,0.3489137590520079,0.391705069124424,5
490700,494,779,769,2042,490700,0.24191968658178256,0.38148873653281096,0.37659157688540645,5
490800,282,299,540,1121,490800,0.25156110615521854,0.26672613737734163,0.4817127564674398,6
490900,344,364,491,1199,490900,0.28690575479566305,0.3035863219349458,0.40950792326939117,5
491000,497,593,657,1747,491000,0.28448769318832284,0.33943903835145967,0.3760732684602175,5
491100,71,64,79,214,491100,0.3317757009345794,0.29906542056074764,0.3691588785046729,2
491200,54,71,72,197,491200,0.27411167512690354,0.3604060913705584,0.36548223350253806,5
491300,393,585,540,1518,491300,0.25889328063241107,0.38537549407114624,0.3557312252964427,5
491400,381,538,471,1390,491400,0.2741007194244604,0.38705035971223023,0.33884892086330937,5
491500,320,477,491,1288,491500,0.2484472049689441,0.3703416149068323,0.3812111801242236,5
491600,258,364,246,868,491600,0.29723502304147464,0.41935483870967744,0.2834101382488479,4
491700,405,609,582,1596,491700,0.25375939849624063,0.3815789473684211,0.36466165413533835,5
491800,315,516,458,1289,491800,0.2443754848719938,0.4003103180760279,0.35531419705197825,5
491900,45,33,46,124,491900,0.3629032258064516,0.2661290322580645,0.3709677419354839,2
492000,572,547,807,1926,492000,0.29698857736240913,0.28400830737279337,0.4190031152647975,6
492100,340,407,472,1219,492100,0.27891714520098443,0.3338802296964725,0.38720262510254305,5
492300,547,745,843,2135,492300,0.25620608899297426,0.34894613583138173,0.394847775175644,5
492400,272,330,337,939,492400,0.2896698615548456,0.3514376996805112,0.3588924387646432,5
492500,200,202,249,651,492500,0.30721966205837176,0.3102918586789555,0.3824884792626728,3
492600,575,696,676,1947,492600,0.2953261427837699,0.3574730354391371,0.34720082177709294,5
492700,490,626,662,1778,492700,0.2755905511811024,0.35208098987626546,0.37232845894263217,5
492800,245,334,313,892,492800,0.27466367713004486,0.3744394618834081,0.3508968609865471,5
492900,170,201,198,569,492900,0.29876977152899825,0.3532513181019332,0.34797891036906853,5
517000,311,385,949,1645,517000,0.1890577507598784,0.23404255319148937,0.5768996960486322,6
517101,489,760,1258,2507,517101,0.1950538492221779,0.30315117670522534,0.5017949740725968,5
517102,281,296,715,1292,517102,0.21749226006191952,0.22910216718266255,0.5534055727554179,6
517200,838,1113,1736,3687,517200,0.22728505560075943,0.3018714401952807,0.4708435042039599,5
517301,318,404,716,1438,517301,0.2211404728789986,0.2809457579972184,0.49791376912378305,6
517302,527,648,1186,2361,517302,0.22321050402371875,0.2744599745870394,0.5023295213892418,6
517400,533,534,1420,2487,517400,0.2143144350623241,0.2147165259348613,0.5709690390028146,6
517500,375,363,1121,1859,517500,0.20172135556750942,0.1952662721893491,0.6030123722431415,6
517600,425,532,1251,2208,517600,0.192481884057971,0.24094202898550723,0.5665760869565217,6
517701,554,603,1896,3053,517701,0.18146085817228955,0.19751064526695053,0.6210284965607599,6
517705,172,215,652,1039,517705,0.16554379210779596,0.20692974013474494,0.6275264677574591,6
517801,247,304,928,1479,517801,0.16700473292765383,0.20554428668018931,0.6274509803921569,6
517802,347,392,924,1663,517802,0.20865904990980155,0.23571858087793146,0.555622369212267,6
517901,512,557,1397,2466,517901,0.20762368207623683,0.22587185725871858,0.5665044606650446,6
517902,320,336,804,1460,517902,0.2191780821917808,0.23013698630136986,0.5506849315068493,6
518000,638,790,1886,3314,518000,0.19251659625829812,0.2383826191913096,0.5691007845503923,6
518100,305,286,828,1419,518100,0.2149400986610289,0.20155038759689922,0.5835095137420718,6
518201,340,369,1244,1953,518201,0.1740911418330773,0.1889400921658986,0.636968766001024,6
518203,308,369,1124,1801,518203,0.17101610216546362,0.2048861743475847,0.6240977234869517,6
518204,410,399,1306,2115,518204,0.1938534278959811,0.18865248226950354,0.6174940898345154,6
518300,525,478,1595,2598,518300,0.20207852193995382,0.18398768283294842,0.6139337952270978,6
518400,389,447,1272,2108,518400,0.18453510436432638,0.2120493358633776,0.603415559772296,6
518501,567,574,1635,2776,518501,0.2042507204610951,0.20677233429394812,0.5889769452449568,6
518502,296,362,848,1506,518502,0.19654714475431606,0.2403718459495352,0.5630810092961488,6
518600,350,342,1052,1744,518600,0.2006880733944954,0.19610091743119265,0.6032110091743119,6
518700,484,524,1578,2586,518700,0.1871616395978345,0.2026295436968291,0.6102088167053364,6
518800,311,324,971,1606,518800,0.19364881693648817,0.20174346201743462,0.6046077210460772,6
518900,780,1064,2064,3908,518900,0.19959058341862845,0.27226202661207777,0.5281473899692938,6
519000,728,869,1785,3382,519000,0.21525724423418097,0.2569485511531638,0.5277942046126552,6
519100,687,852,1796,3335,519100,0.20599700149925038,0.255472263868066,0.5385307346326836,6
519200,704,835,1720,3259,519200,0.21601718318502608,0.256213562442467,0.5277692543725069,6
519300,770,1011,1589,3370,519300,0.228486646884273,0.3,0.471513353115727,5
519400,523,576,1295,2394,519400,0.2184628237259816,0.24060150375939848,0.5409356725146199,6
519500,595,787,1703,3085,519500,0.19286871961102106,0.25510534846029176,0.5520259319286872,6
519601,440,503,1399,2342,519601,0.18787361229718189,0.2147736976942784,0.5973526900085397,6
519602,231,245,699,1175,519602,0.19659574468085106,0.20851063829787234,0.5948936170212766,6
519702,478,593,1590,2661,519702,0.1796317173994739,0.22284855317549793,0.5975197294250282,6
519703,365,403,1108,1876,519703,0.19456289978678037,0.21481876332622601,0.5906183368869936,6
519704,335,320,948,1603,519704,0.20898315658140987,0.19962570180910794,0.5913911416094823,6
519801,303,321,771,1395,519801,0.2172043010752688,0.23010752688172043,0.5526881720430108,6
519802,571,528,1499,2598,519802,0.21978444957659737,0.20323325635103925,0.5769822940723633,6
519900,632,636,1607,2875,519900,0.21982608695652173,0.22121739130434784,0.5589565217391305,6
520001,879,795,2037,3711,520001,0.2368633791430881,0.21422797089733225,0.5489086499595797,6
520002,565,525,1324,2414,520002,0.23405136702568352,0.21748135874067936,0.5484672742336372,6
520100,548,566,1620,2734,520100,0.20043891733723482,0.20702267739575714,0.5925384052670081,6
520200,379,458,940,1777,520200,0.21328081035453011,0.2577377602701182,0.5289814293753518,6
520300,648,759,1774,3181,520300,0.20370952530650738,0.23860421251178873,0.5576862621817039,6
520401,482,580,1255,2317,520401,0.2080276219249029,0.2503236944324558,0.5416486836426413,6
520402,528,602,1252,2382,520402,0.2216624685138539,0.25272879932829556,0.5256087321578505,6
520501,455,564,1247,2266,520501,0.20079435127978817,0.24889673433362755,0.5503089143865842,6
520502,708,652,1625,2985,520502,0.2371859296482412,0.2184254606365159,0.5443886097152428,6
520600,692,861,1763,3316,520600,0.20868516284680338,0.25965018094089265,0.531664656212304,6
520700,570,591,1531,2692,520700,0.21173848439821694,0.21953937592867756,0.5687221396731055,6
520800,510,498,1247,2255,520800,0.2261640798226164,0.22084257206208427,0.5529933481152993,6
520900,617,538,1458,2613,520900,0.2361270570225794,0.2058936088786835,0.5579793340987371,6
521000,596,633,1424,2653,521000,0.2246513381078025,0.23859781379570297,0.5367508480964945,6
521100,494,582,1377,2453,521100,0.20138605788830005,0.23726049735018345,0.5613534447615165,6
521200,364,409,869,1642,521200,0.22168087697929353,0.24908647990255786,0.5292326431181485,6
521301,322,283,749,1354,521301,0.2378138847858198,0.20901033973412111,0.553175775480059,6
521302,653,680,1622,2955,521302,0.2209813874788494,0.23011844331641285,0.5489001692047377,6
521400,660,654,2001,3315,521400,0.19909502262443438,0.19728506787330316,0.6036199095022624,6
521500,557,592,1566,2715,521500,0.20515653775322285,0.21804788213627993,0.5767955801104973,6
521601,484,516,1309,2309,521601,0.20961455175400606,0.2234733650931139,0.56691208315288,6
521602,391,355,1035,1781,521602,0.21953958450308816,0.19932622122403143,0.5811341942728804,6
521700,551,520,1395,2466,521700,0.22343876723438766,0.21086780210867803,0.5656934306569343,6
521801,403,446,1186,2035,521801,0.19803439803439804,0.21916461916461916,0.5828009828009828,6
521802,423,445,1319,2187,521802,0.1934156378600823,0.2034750800182899,0.6031092821216278,6
521902,481,466,1358,2305,521902,0.2086767895878525,0.20216919739696312,0.5891540130151843,6
522000,912,1126,1849,3887,522000,0.23462824800617443,0.28968356058657063,0.47568819140725493,6
522700,551,524,1588,2663,522700,0.2069095005632745,0.19677055951933908,0.5963199399173864,6
590100,464,745,759,1968,590100,0.23577235772357724,0.3785569105691057,0.3856707317073171,5
590201,246,412,368,1026,590201,0.23976608187134502,0.4015594541910331,0.3586744639376218,5
590202,449,576,840,1865,590202,0.24075067024128685,0.3088471849865952,0.450402144772118,5
590300,410,729,631,1770,590300,0.23163841807909605,0.411864406779661,0.35649717514124296,5
590400,526,990,916,2432,590400,0.21628289473684212,0.40707236842105265,0.37664473684210525,5
590500,334,557,495,1386,590500,0.240981240981241,0.4018759018759019,0.35714285714285715,5
590600,212,382,288,882,590600,0.24036281179138322,0.4331065759637188,0.32653061224489793,5
590700,441,706,571,1718,590700,0.25669383003492435,0.4109429569266589,0.33236321303841676,5
590800,584,744,921,2249,590800,0.259670964873277,0.3308136949755447,0.4095153401511783,5
590900,297,390,429,1116,590900,0.2661290322580645,0.34946236559139787,0.3844086021505376,5
591000,349,445,536,1330,591000,0.262406015037594,0.33458646616541354,0.4030075187969925,5
591100,375,479,397,1251,591100,0.2997601918465228,0.3828936850519584,0.3173461231015188,5
591200,203,254,315,772,591200,0.26295336787564766,0.3290155440414508,0.40803108808290156,5
591300,86,114,152,352,591300,0.24431818181818182,0.32386363636363635,0.4318181818181818,5
591400,582,956,830,2368,591400,0.24577702702702703,0.40371621621621623,0.35050675675675674,5
591500,394,638,643,1675,591500,0.23522388059701493,0.3808955223880597,0.3838805970149254,5
591600,433,720,682,1835,591600,0.23596730245231606,0.3923705722070845,0.37166212534059945,5
610000,119,112,232,463,610000,0.2570194384449244,0.24190064794816415,0.5010799136069114,6
640001,16,18,10,44,640001,0.36363636363636365,0.4090909090909091,0.22727272727272727,1
640002,83,93,193,369,640002,0.22493224932249323,0.25203252032520324,0.5230352303523035,6
740100,518,653,695,1866,740100,0.27759914255091106,0.34994640943194,0.372454448017149,5
740200,563,734,765,2062,740200,0.27303588748787583,0.3559650824442289,0.37099903006789525,5
740300,60,62,100,222,740300,0.2702702702702703,0.27927927927927926,0.45045045045045046,6
740400,562,854,764,2180,740400,0.25779816513761467,0.39174311926605504,0.3504587155963303,5
740500,463,571,526,1560,740500,0.2967948717948718,0.366025641025641,0.3371794871794872,5
740600,375,478,444,1297,740600,0.2891287586738628,0.36854279105628374,0.34232845026985353,5
740700,467,687,672,1826,740700,0.255750273822563,0.37623220153340636,0.36801752464403065,5
740800,384,465,410,1259,740800,0.3050039714058777,0.369340746624305,0.3256552819698173,3
940000,802,1310,1278,3390,940000,0.23657817109144544,0.3864306784660767,0.3769911504424779,5
940001,133,204,145,482,940001,0.27593360995850624,0.42323651452282157,0.3008298755186722,5
940100,808,1224,1096,3128,940100,0.25831202046035806,0.391304347826087,0.35038363171355497,5
940101,332,505,340,1177,940101,0.2820730671197961,0.4290569243840272,0.2888700084961767,4
940102,545,895,732,2172,940102,0.2509208103130755,0.4120626151012891,0.3370165745856354,5
940103,480,545,719,1744,940103,0.27522935779816515,0.3125,0.41227064220183485,5
940200,1069,1631,1620,4320,940200,0.2474537037037037,0.37754629629629627,0.375,5
940300,1358,2081,1512,4951,940300,0.2742880226216926,0.4203191274490002,0.3053928499293072,5
940401,857,1127,1433,3417,940401,0.250804799531753,0.32982148083113844,0.41937371963710857,5
940403,594,808,1074,2476,940403,0.23990306946688206,0.3263327948303716,0.43376413570274636,5
940600,804,1271,1253,3328,940600,0.24158653846153846,0.3819110576923077,0.37650240384615385,5
940700,422,471,735,1628,940700,0.2592137592137592,0.2893120393120393,0.4514742014742015,6
950100,3603,5077,5599,14279,950100,0.2523285944393865,0.355557111842566,0.39211429371804746,5
950200,3158,4435,4452,12045,950200,0.2621834786218348,0.36820257368202575,0.3696139476961395,5
950300,4126,5581,5963,15670,950300,0.26330567964262924,0.35615826419910657,0.3805360561582642,5
950400,3866,5079,5253,14198,950400,0.2722918720946612,0.3577264403437104,0.3699816875616284,5
950500,2913,3823,3790,10526,950500,0.27674330229906896,0.3631958958768763,0.3600608018240547,5
950501,381,380,397,1158,950501,0.3290155440414508,0.3281519861830743,0.34283246977547494,3
950502,274,362,383,1019,950502,0.2688910696761531,0.35525024533856725,0.3758586849852797,5
950600,2052,2707,2781,7540,950600,0.27214854111405834,0.35901856763925727,0.36883289124668434,5
950700,2503,3308,3038,8849,950700,0.2828568199796587,0.3738275511357215,0.34331562888461975,5
950800,1988,2426,2456,6870,950800,0.2893740902474527,0.35312954876273656,0.35749636098981075,5
950900,2157,2626,2653,7436,950900,0.29007530930607855,0.3531468531468531,0.3567778375470683,5
951000,1956,2504,2545,7005,951000,0.2792291220556745,0.3574589578872234,0.36331192005710206,5
951100,2001,2509,2946,7456,951100,0.2683744635193133,0.3365075107296137,0.39511802575107297,5
951200,2734,3505,4254,10493,951200,0.26055465548460877,0.33403221195082433,0.40541313256456685,5
951300,1880,2419,2838,7137,951300,0.2634160011209192,0.33893792910186354,0.39764606977721734,5
951400,1092,1421,1668,4181,951400,0.2611815355178187,0.33987084429562303,0.3989476201865582,5
951500,722,847,990,2559,951500,0.2821414615084017,0.330988667448222,0.38686987104337633,5
951600,613,904,1023,2540,951600,0.24133858267716535,0.35590551181102364,0.402755905511811,5
951700,958,1337,1506,3801,951700,0.25203893712181,0.35174953959484345,0.39621152328334647,5
951800,976,1227,912,3115,951800,0.313322632423756,0.393900481540931,0.292776886035313,1
951900,555,827,842,2224,951900,0.24955035971223022,0.37185251798561153,0.37859712230215825,5
952000,505,786,782,2073,952000,0.24360829715388327,0.3791606367583213,0.37723106608779544,5
952100,758,1001,904,2663,952100,0.2846413819001127,0.3758918512955314,0.339466766804356,5
952200,595,743,1128,2466,952200,0.24128142741281428,0.3012976480129765,0.45742092457420924,5
952300,356,539,543,1438,952300,0.24756606397774686,0.3748261474269819,0.3776077885952712,5
952400,553,678,853,2084,952400,0.2653550863723608,0.3253358925143954,0.40930902111324374,5
952500,614,788,1087,2489,952500,0.24668541582965045,0.3165930092406589,0.43672157492969066,5
952600,529,645,1001,2175,952600,0.2432183908045977,0.296551724137931,0.46022988505747126,6
952700,290,362,543,1195,952700,0.24267782426778242,0.302928870292887,0.45439330543933054,5
952800,380,458,697,1535,952800,0.247557003257329,0.298371335504886,0.45407166123778503,6
952900,574,672,1126,2372,952900,0.24198988195615515,0.28330522765598654,0.47470489038785835,6
953000,205,269,310,784,953000,0.2614795918367347,0.34311224489795916,0.39540816326530615,5
953300,512,550,919,1981,953300,0.2584553255931348,0.27763755678950025,0.463907117617365,6
953400,504,524,771,1799,953400,0.2801556420233463,0.29127292940522514,0.42857142857142855,6
953500,378,374,546,1298,953500,0.29121725731895226,0.288135593220339,0.4206471494607088,6
953600,612,764,1241,2617,953600,0.23385555980129918,0.2919373328238441,0.4742071073748567,6
953700,653,723,1229,2605,953700,0.2506717850287908,0.2775431861804223,0.47178502879078693,6
953800,483,501,745,1729,953800,0.2793522267206478,0.28976286871023715,0.4308849045691151,6
953900,553,647,1006,2206,953900,0.25067996373526746,0.2932910244786945,0.45602901178603805,6
954000,562,741,974,2277,954000,0.24681598594642074,0.3254281949934124,0.4277558190601669,5
954100,505,778,975,2258,954100,0.22364924712134632,0.3445527015057573,0.43179805137289634,5
954200,607,694,1192,2493,954200,0.24348174889691135,0.27837946249498596,0.47813878860810266,6
954400,768,871,1435,3074,954400,0.2498373454782043,0.2833441769681197,0.466818477553676,6
954500,345,477,504,1326,954500,0.26018099547511314,0.3597285067873303,0.38009049773755654,5
954600,169,191,278,638,954600,0.26489028213166144,0.2993730407523511,0.43573667711598746,6
954700,176,212,301,689,954700,0.25544267053701014,0.3076923076923077,0.43686502177068215,5
954800,552,708,629,1889,954800,0.2922181048173637,0.37480148226574905,0.33298041291688724,5
954900,197,269,307,773,954900,0.25485122897800777,0.34799482535575677,0.39715394566623546,5
955000,533,710,909,2152,955000,0.24767657992565056,0.3299256505576208,0.42239776951672864,5
955300,230,277,336,843,955300,0.27283511269276395,0.32858837485172004,0.398576512455516,5
955400,419,472,821,1712,955400,0.2447429906542056,0.2757009345794392,0.47955607476635514,6
960100,774,1123,1045,2942,960100,0.26308633582596874,0.3817131203263086,0.35520054384772265,5
960200,1169,1598,1378,4145,960200,0.2820265379975875,0.38552472858866105,0.33244873341375153,5
960300,1195,1443,1422,4060,960300,0.29433497536945813,0.35541871921182266,0.3502463054187192,5
960400,886,1097,1096,3079,960400,0.28775576485872034,0.35628450795712896,0.3559597271841507,5
960498,346,408,360,1114,960498,0.3105924596050269,0.36624775583482944,0.3231597845601436,3
960500,835,1060,947,2842,960500,0.29380717804363127,0.3729767769176636,0.3332160450387051,5
960598,671,888,834,2393,960598,0.28040117007939824,0.3710823234433765,0.34851650647722526,5
960600,966,1104,1067,3137,960600,0.3079375199234938,0.3519285941982786,0.3401338858782276,3
960700,587,775,703,2065,960700,0.28426150121065374,0.37530266343825663,0.34043583535108957,5
960702,381,447,383,1211,960702,0.314616019818332,0.36911643270024774,0.31626754748142033,3
960800,1105,1439,1208,3752,960800,0.2945095948827292,0.3835287846481876,0.32196162046908317,5
960900,795,1080,989,2864,960900,0.2775837988826816,0.3770949720670391,0.34532122905027934,5
961000,1470,2160,2073,5703,961000,0.2577590741714887,0.3787480273540242,0.3634928984744871,5
961100,1115,1604,1858,4577,961100,0.2436093511033428,0.3504478916320734,0.4059427572645838,5
961200,1457,1774,2072,5303,961200,0.2747501414293796,0.33452762587214785,0.39072223269847256,5
961300,1183,1659,1652,4494,961300,0.2632398753894081,0.3691588785046729,0.367601246105919,5
961400,960,1207,1186,3353,961400,0.2863107664777811,0.35997614076946016,0.35371309275275875,5
961500,497,661,787,1945,961500,0.25552699228791775,0.3398457583547558,0.40462724935732647,5
961600,771,876,911,2558,961600,0.3014073494917905,0.3424550430023456,0.35613760750586393,3
961700,857,1046,1052,2955,961700,0.29001692047377325,0.3539763113367174,0.3560067681895093,5
961800,920,1092,1332,3344,961800,0.2751196172248804,0.326555023923445,0.39832535885167464,5
961900,433,548,452,1433,961900,0.30216329378925333,0.38241451500348916,0.3154221912072575,3
962000,372,526,562,1460,962000,0.2547945205479452,0.36027397260273974,0.38493150684931504,5
962100,276,407,536,1219,962100,0.22641509433962265,0.3338802296964725,0.43970467596390483,5
962200,599,791,823,2213,962200,0.2706732941708089,0.35743334839584273,0.3718933574333484,5
962300,732,854,1957,3543,962300,0.20660457239627433,0.2410386677956534,0.5523567598080723,6
962400,376,448,640,1464,962400,0.2568306010928962,0.30601092896174864,0.4371584699453552,5
962500,310,346,432,1088,962500,0.2849264705882353,0.3180147058823529,0.39705882352941174,5
962600,251,337,468,1056,962600,0.23768939393939395,0.3191287878787879,0.4431818181818182,5
962700,351,456,605,1412,962700,0.24858356940509915,0.32294617563739375,0.42847025495750707,5
962800,377,520,763,1660,962800,0.22710843373493975,0.3132530120481928,0.45963855421686745,5
962900,314,349,619,1282,962900,0.24492979719188768,0.27223088923556943,0.4828393135725429,6
963000,445,535,867,1847,963000,0.2409312398484028,0.2896589063345966,0.46940985381700057,6
970100,2208,3164,2796,8168,970100,0.2703232125367287,0.38736532810969637,0.34231145935357493,5
970200,2331,3275,3206,8812,970200,0.26452564684521107,0.3716522923286428,0.36382206082614615,5
970300,1808,2582,2751,7141,970300,0.253185828315362,0.361574009242403,0.38524016244223497,5
970400,1952,2692,2685,7329,970400,0.2663392004366216,0.36730795470050487,0.3663528448628735,5
970500,2552,3747,3354,9653,970500,0.2643737698124935,0.3881694809903657,0.3474567491971408,5
970600,2371,3384,2969,8724,970600,0.2717790004585053,0.3878954607977992,0.34032553874369553,5
970601,446,692,608,1746,970601,0.2554410080183276,0.3963344788087056,0.34822451317296677,5
970602,361,582,558,1501,970602,0.24050632911392406,0.3877415056628914,0.37175216522318455,5
970700,1762,2435,2238,6435,970700,0.2738150738150738,0.37839937839937837,0.34778554778554777,5
970800,1265,1702,1543,4510,970800,0.2804878048780488,0.37738359201773836,0.34212860310421284,5
970801,430,567,698,1695,970801,0.2536873156342183,0.3345132743362832,0.41179941002949855,5
970802,369,615,665,1649,970802,0.22377198302001214,0.37295330503335355,0.40327471194663433,5
970900,1766,2398,2314,6478,970900,0.272615004631059,0.37017598024081505,0.357209015128126,5
971000,2210,2958,3145,8313,971000,0.2658486707566462,0.3558282208588957,0.3783231083844581,5
971100,1456,2166,1871,5493,971100,0.265064627707992,0.3943200436919716,0.3406153286000364,5
971200,1305,1912,1815,5032,971200,0.2593402225755167,0.3799682034976153,0.36069157392686807,5
971300,808,1056,1021,2885,971300,0.2800693240901213,0.3660311958405546,0.3538994800693241,5
971400,806,1032,1007,2845,971400,0.28330404217926186,0.36274165202108966,0.3539543057996485,5
971500,554,775,934,2263,971500,0.24480777728678746,0.3424657534246575,0.412726469288555,5
980000,29,31,32,92,980000,0.31521739130434784,0.33695652173913043,0.34782608695652173,3
980002,11,10,15,36,980002,0.3055555555555556,0.2777777777777778,0.4166666666666667,2
980003,7,10,7,24,980003,0.2916666666666667,0.4166666666666667,0.2916666666666667,4
980100,110,103,264,477,980100,0.23060796645702306,0.21593291404612158,0.5534591194968553,6
981000,126,143,337,606,981000,0.2079207920792079,0.23597359735973597,0.5561056105610561,6
981100,98,83,220,401,981100,0.24438902743142144,0.20698254364089774,0.5486284289276808,6
982000,93,89,239,421,982000,0.2209026128266033,0.21140142517814728,0.5676959619952494,6
982100,89,115,187,391,982100,0.22762148337595908,0.29411764705882354,0.4782608695652174,6
983000,84,79,202,365,983000,0.23013698630136986,0.21643835616438356,0.5534246575342465,6
984000,52,83,134,269,984000,0.19330855018587362,0.30855018587360594,0.49814126394052044,5
985000,91,103,367,561,985000,0.1622103386809269,0.1836007130124777,0.6541889483065954,6
990000,110,98,97,305,990000,0.36065573770491804,0.32131147540983607,0.3180327868852459,3
990001,9,17,8,34,990001,0.2647058823529412,0.5,0.23529411764705882,4
990100,198,215,217,630,990100,0.3142857142857143,0.3412698412698413,0.34444444444444444,3
990200,49,57,47,153,990200,0.3202614379084967,0.37254901960784315,0.30718954248366015,3
990301,20,37,32,89,990301,0.2247191011235955,0.4157303370786517,0.3595505617977528,5
990302,38,34,34,106,990302,0.3584905660377358,0.32075471698113206,0.32075471698113206,3
990400,31,36,43,110,990400,0.2818181818181818,0.32727272727272727,0.39090909090909093,5
