Census Tract,CE01totcounts,CE02totcounts,CE03totcounts,C000totcounts,ct,CE01Percent,CE02Percent,CE03Percent,TractLabel
000100,2950,3512,5720,12182,000100,0.24216056476769005,0.288294204564111,0.469545230668199,6
000101,522,759,785,2066,000101,0.2526621490803485,0.3673765730880929,0.3799612778315586,5
000103,705,964,947,2616,000103,0.2694954128440367,0.36850152905198774,0.36200305810397554,5
000104,30,39,29,98,000104,0.30612244897959184,0.3979591836734694,0.29591836734693877,1
000110,496,632,418,1546,000110,0.3208279430789133,0.4087968952134541,0.2703751617076326,1
000200,3971,5239,4086,13296,000200,0.2986612515042118,0.3940282791817088,0.3073104693140794,5
000201,1093,1537,1555,4185,000201,0.26117084826762244,0.36726403823178017,0.3715651135005974,5
000202,1085,1320,2031,4436,000202,0.24458972046889088,0.2975653742110009,0.4578449053201082,6
000203,292,374,641,1307,000203,0.2234123947972456,0.2861514919663351,0.4904361132364193,6
000300,2821,3831,3892,10544,000300,0.2675455235204856,0.36333459787556904,0.36911987860394535,5
000301,465,403,1536,2404,000301,0.19342762063227953,0.16763727121464225,0.6389351081530782,6
000400,2157,3195,3033,8385,000400,0.25724508050089445,0.3810375670840787,0.36171735241502684,5
000401,929,1220,1727,3876,000401,0.23968008255933954,0.31475748194014447,0.445562435500516,5
000402,1209,1640,2277,5126,000402,0.23585641825985174,0.31993757315645727,0.44420600858369097,5
000403,378,633,899,1910,000403,0.19790575916230366,0.33141361256544505,0.4706806282722513,5
000404,61,64,80,205,000404,0.2975609756097561,0.3121951219512195,0.3902439024390244,5
000500,1980,2336,2877,7193,000500,0.27526762129848464,0.3247601835117475,0.39997219518976784,5
000501,1233,1519,2103,4855,000501,0.2539649845520082,0.3128733264675592,0.43316168898043256,5
000502,861,1083,1915,3859,000502,0.22311479657942473,0.2806426535371858,0.4962425498833895,6
000600,5387,6866,7099,19352,000600,0.27836916081025215,0.3547953699875982,0.36683546920214966,5
000700,4629,5649,10673,20951,000700,0.22094410767982436,0.26962913464751087,0.5094267576726648,6
000701,348,487,948,1783,000701,0.195176668536175,0.27313516545148625,0.5316881660123387,6
000702,424,591,1018,2033,000702,0.2085587801278898,0.29070339399901624,0.5007378258730939,6
000800,3740,4301,4447,12488,000800,0.29948750800768736,0.3444106342088405,0.35610185778347214,5
000801,541,721,1622,2884,000801,0.1875866851595007,0.25,0.5624133148404993,6
000802,237,336,569,1142,000802,0.2075306479859895,0.29422066549912435,0.4982486865148862,6
000803,441,688,1134,2263,000803,0.1948740609809987,0.3040212107821476,0.5011047282368537,5
000900,2991,3966,6667,13624,000900,0.21953904873752203,0.29110393423370523,0.48935701702877277,6
001000,3940,5144,4519,13603,001000,0.2896419907373374,0.3781518782621481,0.3322061310005146,5
001001,140,154,489,783,001001,0.17879948914431673,0.1966794380587484,0.6245210727969349,6
001002,608,816,523,1947,001002,0.3122752953261428,0.41910631741140214,0.26861838726245507,1
001100,3052,3786,4252,11090,001100,0.2752028854824166,0.34138863841298467,0.3834084761045987,5
001101,284,452,380,1116,001101,0.25448028673835127,0.4050179211469534,0.34050179211469533,5
001102,462,714,748,1924,001102,0.24012474012474014,0.3711018711018711,0.3887733887733888,5
001200,2025,2648,3188,7861,001200,0.25760081414578295,0.3368528177076708,0.40554636814654627,5
001300,2056,2406,5300,9762,001300,0.21061257938946937,0.2464658881376767,0.5429215324728539,6
001301,310,450,786,1546,001301,0.20051746442432083,0.2910737386804657,0.5084087968952135,6
001302,324,541,649,1514,001302,0.21400264200792601,0.357331571994716,0.428665785997358,5
001303,511,749,835,2095,001303,0.24391408114558472,0.3575178997613365,0.39856801909307876,5
001400,2322,3179,3226,8727,001400,0.2660708147129598,0.36427180016042165,0.36965738512661855,5
001401,572,742,1719,3033,001401,0.18859215298384438,0.24464226838114078,0.5667655786350149,6
001402,953,1152,1247,3352,001402,0.28430787589498807,0.3436754176610978,0.3720167064439141,5
001403,252,363,589,1204,001403,0.20930232558139536,0.3014950166112957,0.489202657807309,5
001500,3223,4162,5917,13302,001500,0.24229439182077883,0.3128852804089611,0.4448203277702601,5
001501,402,495,2018,2915,001501,0.1379073756432247,0.16981132075471697,0.6922813036020583,6
001502,603,788,3773,5164,001502,0.1167699457784663,0.15259488768396592,0.7306351665375678,6
001503,233,264,614,1111,001503,0.20972097209720972,0.2376237623762376,0.5526552655265526,6
001504,379,465,1068,1912,001504,0.19822175732217573,0.24320083682008367,0.5585774058577406,6
001505,170,292,530,992,001505,0.17137096774193547,0.29435483870967744,0.5342741935483871,6
001600,5077,6130,7294,18501,001600,0.27441759904870006,0.33133344143559806,0.3942489595157019,5
001700,2461,3352,4480,10293,001700,0.23909453026328573,0.3256582143204119,0.4352472554163023,5
001701,469,556,465,1490,001701,0.31476510067114094,0.3731543624161074,0.31208053691275167,3
001702,511,620,702,1833,001702,0.27877795962902346,0.3382433169667212,0.3829787234042553,5
001800,4266,5419,5600,15285,001800,0.2790971540726202,0.35453058554138045,0.36637226038599935,5
001801,954,1009,2057,4020,001801,0.2373134328358209,0.25099502487562186,0.5116915422885572,6
001802,896,977,1632,3505,001802,0.25563480741797434,0.2787446504992867,0.46562054208273895,6
001900,2767,3667,4340,10774,001900,0.2568219788379432,0.34035641358826807,0.40282160757378876,5
001901,598,663,1199,2460,001901,0.24308943089430896,0.26951219512195124,0.48739837398373986,6
001902,320,414,878,1612,001902,0.19851116625310175,0.25682382133995035,0.5446650124069479,6
002000,4475,6077,5960,16512,002000,0.27101501937984496,0.36803536821705424,0.36094961240310075,5
002001,232,327,613,1172,002001,0.19795221843003413,0.2790102389078498,0.523037542662116,6
002002,266,371,781,1418,002002,0.18758815232722145,0.2616361071932299,0.5507757404795487,6
002100,2540,3418,7026,12984,002100,0.19562538508934071,0.2632470733210105,0.5411275415896488,6
002101,615,806,1065,2486,002101,0.24738535800482703,0.3242156074014481,0.42839903459372486,5
002103,280,251,749,1280,002103,0.21875,0.19609375,0.58515625,6
002104,443,511,1244,2198,002104,0.20154686078252956,0.23248407643312102,0.5659690627843494,6
002105,161,188,442,791,002105,0.20353982300884957,0.23767383059418457,0.5587863463969659,6
002106,229,415,504,1148,002106,0.1994773519163763,0.3614982578397213,0.43902439024390244,5
002107,161,208,455,824,002107,0.1953883495145631,0.2524271844660194,0.5521844660194175,6
002200,1936,2857,2633,7426,002200,0.2607056288715325,0.38472932938324805,0.3545650417452195,5
002201,881,1124,1834,3839,002201,0.2294868455326908,0.2927845793175306,0.47772857514977857,6
002202,585,638,1721,2944,002202,0.19870923913043478,0.21671195652173914,0.584578804347826,6
002203,141,188,419,748,002203,0.18850267379679145,0.25133689839572193,0.5601604278074866,6
002204,329,396,1063,1788,002204,0.18400447427293065,0.2214765100671141,0.5945190156599552,6
002300,3308,4551,3886,11745,002300,0.28165176670923797,0.3874840357598978,0.3308641975308642,5
002400,1998,2664,1644,6306,002400,0.3168411037107517,0.4224548049476689,0.26070409134157946,1
002401,154,218,432,804,002401,0.19154228855721392,0.27114427860696516,0.5373134328358209,6
002402,244,330,818,1392,002402,0.1752873563218391,0.23706896551724138,0.5876436781609196,6
002403,491,616,1097,2204,002403,0.22277676950998185,0.279491833030853,0.49773139745916517,6
002404,206,331,609,1146,002404,0.17975567190226877,0.28883071553228623,0.5314136125654451,6
002405,262,344,649,1255,002405,0.20876494023904382,0.27410358565737053,0.5171314741035856,6
002500,1986,2673,1738,6397,002500,0.3104580272002501,0.4178521181803971,0.2716898546193528,1
002502,308,260,187,755,002502,0.40794701986754967,0.3443708609271523,0.247682119205298,1
002600,1018,1553,1441,4012,002600,0.25373878364905283,0.3870887337986042,0.35917248255234296,5
002601,427,548,796,1771,002601,0.24110671936758893,0.3094297007340486,0.4494635798983625,5
002602,519,513,1220,2252,002602,0.23046181172291297,0.227797513321492,0.5417406749555951,6
002700,1161,1419,1395,3975,002700,0.2920754716981132,0.3569811320754717,0.35094339622641507,5
002701,355,397,200,952,002701,0.37289915966386555,0.4170168067226891,0.21008403361344538,1
002702,687,784,380,1851,002702,0.3711507293354943,0.4235548352242031,0.20529443544030254,1
002800,1908,2727,3544,8179,002800,0.23328035212128623,0.3334148428903289,0.43330480498838486,5
002900,2380,2935,3614,8929,002900,0.26654720573412477,0.32870422219733453,0.4047485720685407,5
002901,654,865,769,2288,002901,0.28583916083916083,0.3780594405594406,0.3361013986013986,5
003000,1511,1989,1742,5242,003000,0.28824876001526134,0.3794353300267074,0.3323159099580313,5
003001,504,544,1518,2566,003001,0.19641465315666407,0.21200311769290725,0.5915822291504287,6
003002,355,315,916,1586,003002,0.22383354350567466,0.19861286254728877,0.5775535939470365,6
003100,2190,2611,3769,8570,003100,0.2555425904317386,0.30466744457409567,0.43978996499416567,5
003200,1543,2072,3747,7362,003200,0.20958978538440642,0.28144525944036947,0.5089649551752241,6
003300,2212,2766,5621,10599,003300,0.20869893386168506,0.26096801585055196,0.530333050287763,6
003301,378,524,225,1127,003301,0.33540372670807456,0.4649511978704525,0.19964507542147295,1
003302,385,398,167,950,003302,0.4052631578947368,0.4189473684210526,0.17578947368421052,1
003400,2577,2967,4947,10491,003400,0.2456391192450672,0.2828138404346583,0.4715470403202745,6
003500,1716,2073,1823,5612,003500,0.3057733428367783,0.3693870277975766,0.32483962936564503,3
003600,1703,2518,3180,7401,003600,0.23010403999459533,0.3402242940143224,0.4296716659910823,5
003601,726,851,1029,2606,003601,0.27858787413660785,0.32655410590943973,0.3948580199539524,5
003602,693,729,1158,2580,003602,0.2686046511627907,0.28255813953488373,0.44883720930232557,6
003700,1823,2223,3284,7330,003700,0.24870395634379264,0.3032742155525239,0.4480218281036835,5
003800,2425,2859,4920,10204,003800,0.2376519012152097,0.2801842414739318,0.4821638573108585,6
003802,93,29,22,144,003802,0.6458333333333334,0.2013888888888889,0.1527777777777778,0
003805,605,896,709,2210,003805,0.2737556561085973,0.40542986425339367,0.3208144796380091,5
003900,2403,2956,4958,10317,003900,0.23291654550741495,0.28651739846854707,0.480566056024038,6
003901,191,163,82,436,003901,0.4380733944954128,0.3738532110091743,0.18807339449541285,1
004000,3139,3841,6438,13418,004000,0.23393948427485467,0.28625726635862275,0.4798032493665226,6
004001,867,1079,914,2860,004001,0.30314685314685313,0.37727272727272726,0.3195804195804196,3
004002,124,185,160,469,004002,0.26439232409381663,0.39445628997867804,0.3411513859275053,5
004100,2762,3275,4376,10413,004100,0.2652453663689619,0.31451070776913476,0.4202439258619034,5
004200,2424,3257,4388,10069,004200,0.2407389015791042,0.3234680703148277,0.4357930281060681,5
004300,2282,2892,4344,9518,004300,0.2397562513133011,0.30384534566085314,0.4563984030258458,5
004301,106,82,39,227,004301,0.4669603524229075,0.36123348017621143,0.17180616740088106,1
004302,201,180,105,486,004302,0.41358024691358025,0.37037037037037035,0.21604938271604937,1
004400,1959,2494,7818,12271,004400,0.1596446907342515,0.2032434194442181,0.6371118898215304,6
004401,776,1150,775,2701,004401,0.28730099962976674,0.4257682339874121,0.28693076638282117,4
004402,373,384,98,855,004402,0.43625730994152045,0.44912280701754387,0.11461988304093568,1
004500,1933,2081,4328,8342,004500,0.23171901222728364,0.2494605610165428,0.5188204267561736,6
004600,992,1171,1954,4117,004600,0.24095214962351227,0.2844304104930775,0.47461743988341026,6
004601,464,411,439,1314,004601,0.3531202435312024,0.3127853881278539,0.3340943683409437,3
004602,254,288,99,641,004602,0.3962558502340094,0.44929797191887677,0.1544461778471139,1
004700,1926,2268,4056,8250,004700,0.23345454545454544,0.27490909090909094,0.49163636363636365,6
004701,367,464,268,1099,004701,0.33393994540491356,0.4222020018198362,0.24385805277525022,1
004702,243,352,161,756,004702,0.32142857142857145,0.4656084656084656,0.21296296296296297,1
004800,2018,2596,5593,10207,004800,0.19770745566767906,0.2543352601156069,0.547957284216714,6
004900,1852,2080,4408,8340,004900,0.22206235011990408,0.24940047961630696,0.528537170263789,6
005000,1736,1963,4570,8269,005000,0.20994074253234973,0.23739267142338855,0.5526665860442617,6
005001,609,899,1388,2896,005001,0.2102900552486188,0.3104281767955801,0.47928176795580113,5
005002,756,1046,1693,3495,005002,0.21630901287553647,0.29928469241773964,0.4844062947067239,6
005100,2436,3147,3366,8949,005100,0.27220918538384176,0.3516594032852833,0.37613141133087497,5
005200,1780,1875,3465,7120,005200,0.25,0.2633426966292135,0.4866573033707865,6
005201,439,544,1035,2018,005201,0.21754212091179387,0.26957383548067393,0.5128840436075323,6
005202,405,506,988,1899,005202,0.2132701421800948,0.2664560294892048,0.5202738283307003,6
005300,2127,2494,3479,8100,005300,0.2625925925925926,0.30790123456790125,0.42950617283950615,5
005400,2941,3805,6077,12823,005400,0.22935350541994853,0.2967324339078219,0.4739140606722296,6
005500,1776,2036,2283,6095,005500,0.29138638228055785,0.3340442986054143,0.3745693191140279,5
005501,219,205,1476,1900,005501,0.11526315789473685,0.10789473684210527,0.7768421052631579,6
005502,157,211,905,1273,005502,0.12333071484681854,0.1657501963864886,0.7109190887666929,6
005600,1678,1757,2184,5619,005600,0.2986296494038085,0.3126890905855134,0.38868126001067804,5
005601,338,450,1169,1957,005601,0.17271333673990802,0.22994379151762903,0.5973428717424629,6
005602,226,238,540,1004,005602,0.2250996015936255,0.23705179282868527,0.5378486055776892,6
005700,1505,1757,2494,5756,005700,0.2614662960389159,0.30524669909659485,0.43328700486448923,5
005701,524,636,1594,2754,005701,0.19026870007262164,0.23093681917211328,0.5787944807552651,6
005702,285,310,759,1354,005702,0.21048744460856722,0.22895125553914328,0.5605612998522895,6
005800,2136,2769,4629,9534,005800,0.22404027690371303,0.29043423536815605,0.4855254877281309,6
005801,539,653,417,1609,005801,0.33499067743940336,0.40584213797389684,0.2591671845866998,1
005802,637,784,432,1853,005802,0.34376686454398275,0.423097679438748,0.2331354560172693,1
005900,1999,2310,4197,8506,005900,0.23501058076651776,0.2715730072889725,0.49341641194450975,6
005901,452,556,970,1978,005901,0.22851365015166836,0.2810920121334681,0.4903943377148635,6
005902,790,1084,1839,3713,005902,0.2127659574468085,0.29194721249663347,0.49528683005655805,6
006000,1897,2536,4099,8532,006000,0.22233942803563056,0.2972339428035631,0.48042662916080636,6
006100,2208,2930,5037,10175,006100,0.217002457002457,0.28796068796068797,0.495036855036855,6
006101,379,500,247,1126,006101,0.33658969804618116,0.44404973357015987,0.21936056838365897,1
006102,237,253,124,614,006102,0.38599348534201955,0.41205211726384366,0.20195439739413681,1
006103,282,409,457,1148,006103,0.2456445993031359,0.35627177700348434,0.3980836236933798,5
006200,2001,2656,3307,7964,006200,0.25125565042692116,0.33350075339025614,0.4152435961828227,5
006201,355,591,1000,1946,006201,0.18242548818088386,0.30369989722507706,0.513874614594039,5
006202,400,594,996,1990,006202,0.20100502512562815,0.2984924623115578,0.5005025125628141,6
006300,2909,3315,6093,12317,006300,0.23617764065925145,0.26914021271413496,0.49468214662661364,6
006301,499,607,560,1666,006301,0.2995198079231693,0.36434573829531813,0.33613445378151263,5
006302,257,260,537,1054,006302,0.24383301707779886,0.24667931688804554,0.5094876660341556,6
006400,2288,2915,6360,11563,006400,0.19787252443137593,0.25209720660728185,0.5500302689613422,6
006500,2218,2608,5487,10313,006500,0.21506836032192378,0.25288470862018814,0.5320469310578881,6
006501,690,831,1263,2784,006501,0.2478448275862069,0.2984913793103448,0.4536637931034483,6
006502,301,410,830,1541,006502,0.1953277092796885,0.26606099935107075,0.5386112913692408,6
006600,2037,2421,6320,10778,006600,0.18899610317313045,0.22462423455186492,0.5863796622750046,6
006601,276,385,310,971,006601,0.2842430484037075,0.3964984552008239,0.3192584963954686,5
006602,181,232,389,802,006602,0.2256857855361596,0.2892768079800499,0.4850374064837905,6
006700,2456,2847,6411,11714,006700,0.20966365033293494,0.24304251323203005,0.547293836435035,6
006701,395,516,474,1385,006701,0.2851985559566787,0.3725631768953069,0.3422382671480144,5
006702,329,487,553,1369,006702,0.24032140248356465,0.3557341124908692,0.4039444850255661,5
006800,2069,2590,4915,9574,006800,0.2161061207436808,0.270524336745352,0.5133695425109672,6
006801,559,540,1647,2746,006801,0.2035688273852877,0.19664967225054625,0.5997815003641661,6
006802,506,536,1655,2697,006802,0.18761586948461254,0.19873934000741564,0.6136447905079718,6
006900,2068,2741,5223,10032,006900,0.20614035087719298,0.273225677830941,0.5206339712918661,6
006901,430,518,136,1084,006901,0.3966789667896679,0.477859778597786,0.12546125461254612,1
006902,476,548,332,1356,006902,0.35103244837758113,0.40412979351032446,0.2448377581120944,1
007000,3008,3624,7744,14376,007000,0.20923761825264328,0.25208681135225375,0.5386755703951029,6
007100,2079,2826,5635,10540,007100,0.19724857685009486,0.2681214421252372,0.534629981024668,6
007101,361,430,134,925,007101,0.3902702702702703,0.4648648648648649,0.14486486486486486,1
007102,318,367,157,842,007102,0.37767220902612825,0.4358669833729216,0.18646080760095013,1
007200,1753,2076,5712,9541,007200,0.1837333612828844,0.21758725500471648,0.5986793837123991,6
007202,218,288,245,751,007202,0.29027962716378164,0.38348868175765644,0.3262316910785619,5
007300,1786,2017,5097,8900,007300,0.2006741573033708,0.22662921348314607,0.5726966292134832,6
007302,974,1125,1738,3837,007302,0.253844149074798,0.29319781078967944,0.45295804013552254,6
007303,802,899,1445,3146,007303,0.25492689129052765,0.28575969485060393,0.4593134138588684,6
007304,641,649,1392,2682,007304,0.2390007457121551,0.24198359433258762,0.5190156599552572,6
007400,1323,1815,3451,6589,007400,0.20078919411139778,0.27545909849749584,0.5237517073911064,6
007401,326,448,1119,1893,007401,0.1722134178552562,0.23666138404648707,0.5911251980982567,6
007402,208,177,742,1127,007402,0.18456078083407276,0.15705412599822538,0.6583850931677019,6
007500,2615,3156,6912,12683,007500,0.2061815027990223,0.24883702594023496,0.5449814712607427,6
007600,2163,3059,4306,9528,007600,0.22701511335012595,0.32105373635600337,0.4519311502938707,5
007700,2873,3315,7234,13422,007700,0.21405155714498583,0.24698256593652212,0.5389658769184921,6
007800,2425,3359,6060,11844,007800,0.20474501857480581,0.2836035123269166,0.5116514690982776,6
007801,234,321,432,987,007801,0.23708206686930092,0.3252279635258359,0.4376899696048632,5
007802,182,158,389,729,007802,0.2496570644718793,0.2167352537722908,0.53360768175583,6
007900,2240,2850,4164,9254,007900,0.24205748865355523,0.30797492976010377,0.44996758158634104,5
007901,403,529,701,1633,007901,0.2467850581751378,0.323943661971831,0.4292712798530312,5
007902,792,942,1200,2934,007902,0.26993865030674846,0.3210633946830266,0.40899795501022496,5
007903,469,559,693,1721,007903,0.2725159790819291,0.32481115630447416,0.40267286461359675,5
007904,421,561,638,1620,007904,0.2598765432098765,0.34629629629629627,0.39382716049382716,5
007905,611,678,832,2121,007905,0.28807166430928804,0.31966053748231965,0.39226779820839225,5
008000,1421,1901,3641,6963,008000,0.20407870170903347,0.2730145052419934,0.5229067930489731,6
008001,829,843,1069,2741,008001,0.3024443633710325,0.3075519883254287,0.39000364830353884,3
008002,758,884,1104,2746,008002,0.27603787327021123,0.3219227967953387,0.40203932993445013,5
008003,720,920,930,2570,008003,0.2801556420233463,0.35797665369649806,0.36186770428015563,5
008100,2013,2456,5329,9798,008100,0.20545009185548072,0.2506634006940192,0.5438865074505002,6
008101,741,884,1121,2746,008101,0.26984705025491623,0.3219227967953387,0.4082301529497451,5
008102,780,842,1183,2805,008102,0.27807486631016043,0.3001782531194296,0.42174688057041,5
008200,1725,2375,4563,8663,008200,0.19912270576012928,0.2741544499595983,0.5267228442802724,6
008201,380,492,608,1480,008201,0.25675675675675674,0.3324324324324324,0.41081081081081083,5
008202,583,713,731,2027,008202,0.2876171682289097,0.3517513566847558,0.3606314750863345,5
008300,1574,2133,2410,6117,008300,0.2573156776197482,0.34870034330554195,0.39398397907470983,5
008301,705,1055,1117,2877,008301,0.24504692387904067,0.3667014250955857,0.3882516510253737,5
008302,593,543,1957,3093,008302,0.1917232460394439,0.1755577109602328,0.6327190430003233,6
008400,1495,1987,2093,5575,008400,0.2681614349775785,0.35641255605381167,0.3754260089686099,5
008401,152,161,551,864,008401,0.17592592592592593,0.1863425925925926,0.6377314814814815,6
008403,284,310,997,1591,008403,0.17850408548082966,0.19484600879949718,0.6266499057196732,6
008404,358,469,1230,2057,008404,0.17403986387943607,0.2280019445794847,0.5979581915410792,6
008500,2338,3103,3117,8558,008500,0.2731946716522552,0.3625847160551531,0.36422061229259173,5
008600,1975,2595,2748,7318,008600,0.2698824815523367,0.35460508335610824,0.3755124350915551,5
008601,189,206,962,1357,008601,0.13927781871775977,0.1518054532056006,0.7089167280766396,6
008602,349,354,1337,2040,008602,0.17107843137254902,0.17352941176470588,0.6553921568627451,6
008603,292,270,1563,2125,008603,0.13741176470588234,0.12705882352941175,0.7355294117647059,6
008700,2566,3302,5821,11689,008700,0.21952262811190007,0.28248780905124476,0.49798956283685514,6
008701,395,739,270,1404,008701,0.2813390313390313,0.5263532763532763,0.19230769230769232,4
008702,193,234,110,537,008702,0.35940409683426444,0.43575418994413406,0.2048417132216015,1
008800,2278,3088,6209,11575,008800,0.1968034557235421,0.26678185745140387,0.536414686825054,6
008900,1374,1500,3156,6030,008900,0.22786069651741295,0.24875621890547264,0.5233830845771145,6
008901,495,543,1622,2660,008901,0.18609022556390978,0.20413533834586467,0.6097744360902255,6
008902,374,404,935,1713,008902,0.2183304144775248,0.23584354932866317,0.545826036193812,6
009000,1474,1712,4984,8170,009000,0.18041615667074665,0.209547123623011,0.6100367197062424,6
009004,432,448,923,1803,009004,0.23960066555740434,0.24847476428175264,0.511924570160843,6
009006,889,800,1819,3508,009006,0.2534207525655644,0.22805017103762829,0.5185290763968073,6
009007,913,781,2099,3793,009007,0.24070656472449248,0.20590561560769838,0.5533878196678091,6
009008,619,566,1281,2466,009008,0.25101378751013786,0.22952149229521493,0.5194647201946472,6
009009,839,758,1660,3257,009009,0.2575990175007676,0.2327295056800737,0.5096714768191587,6
009010,973,842,1825,3640,009010,0.2673076923076923,0.23131868131868133,0.5013736263736264,6
009100,1272,1528,4300,7100,009100,0.1791549295774648,0.2152112676056338,0.6056338028169014,6
009104,665,558,1101,2324,009104,0.286144578313253,0.24010327022375216,0.4737521514629948,6
009106,476,475,630,1581,009106,0.3010752688172043,0.30044275774826057,0.3984819734345351,3
009107,744,695,877,2316,009107,0.32124352331606215,0.30008635578583764,0.37867012089810015,3
009109,412,432,643,1487,009109,0.27706792199058505,0.2905178211163416,0.4324142568930733,6
009110,118,113,168,399,009110,0.2957393483709273,0.2832080200501253,0.42105263157894735,6
009112,288,284,370,942,009112,0.3057324840764331,0.30148619957537154,0.39278131634819535,3
009113,843,746,1733,3322,009113,0.2537627934978928,0.22456351595424442,0.5216736905478627,6
009114,483,461,970,1914,009114,0.25235109717868337,0.24085684430512017,0.5067920585161965,6
009115,248,303,412,963,009115,0.25752855659397716,0.3146417445482866,0.42782969885773625,5
009116,664,628,970,2262,009116,0.29354553492484525,0.27763041556145,0.4288240495137047,6
009200,2493,3182,4782,10457,009200,0.23840489624175193,0.3042937745051162,0.4573013292531319,5
009300,1806,2131,4377,8314,009300,0.21722395958624008,0.2563146499879721,0.5264613904257879,6
009301,872,1082,774,2728,009301,0.3196480938416422,0.3966275659824047,0.2837243401759531,1
009302,601,814,698,2113,009302,0.28442972077614764,0.3852342640795078,0.3303360151443445,5
009400,1921,1966,2486,6373,009400,0.30142789894868977,0.308488937705947,0.39008316334536325,3
009401,651,619,1205,2475,009401,0.263030303030303,0.2501010101010101,0.4868686868686869,6
009402,532,478,1047,2057,009402,0.25862907146329606,0.23237724842002916,0.5089936801166748,6
009500,1463,1646,3600,6709,009500,0.21806528543747206,0.24534207780593234,0.5365926367565956,6
009501,643,568,1228,2439,009501,0.26363263632636325,0.23288232882328824,0.5034850348503485,6
009502,872,836,1527,3235,009502,0.2695517774343122,0.25842349304482226,0.47202472952086555,6
009600,2213,2684,4375,9272,009600,0.2386755823986195,0.2894736842105263,0.4718507333908542,6
009601,541,665,949,2155,009601,0.2510440835266821,0.308584686774942,0.4403712296983759,5
009602,513,646,854,2013,009602,0.2548435171385991,0.32091405861897665,0.42424242424242425,5
009603,214,244,61,519,009603,0.4123314065510597,0.4701348747591522,0.11753371868978806,1
009604,149,148,42,339,009604,0.43952802359882004,0.4365781710914454,0.12389380530973451,1
009700,1277,1322,3004,5603,009700,0.227913617704801,0.23594502944850973,0.5361413528466893,6
009701,646,808,1467,2921,009701,0.22115713796644984,0.2766175967134543,0.5022252653200958,6
009702,852,1215,1779,3846,009702,0.22152886115444617,0.3159126365054602,0.4625585023400936,5
009703,366,396,1389,2151,009703,0.1701534170153417,0.18410041841004185,0.6457461645746164,6
009800,2311,3002,6004,11317,009800,0.2042060616771229,0.2652646461076257,0.5305292922152514,6
009900,1051,1426,3326,5803,009900,0.18111321730139582,0.24573496467344477,0.5731518180251594,6
010000,2121,2553,4385,9059,010000,0.23413180262722155,0.28181918534054534,0.48404901203223316,6
010001,448,567,483,1498,010001,0.29906542056074764,0.37850467289719625,0.32242990654205606,5
010002,601,693,680,1974,010002,0.3044579533941236,0.35106382978723405,0.3444782168186423,3
010003,542,667,625,1834,010003,0.2955288985823337,0.36368593238822244,0.34078516902944384,5
010100,3104,4171,6810,14085,010100,0.22037628682996094,0.29613063542776,0.483493077742279,6
010101,1591,1910,3134,6635,010101,0.2397889977392615,0.2878673700075358,0.4723436322532027,6
010102,1429,1860,2521,5810,010102,0.2459552495697074,0.32013769363166955,0.43390705679862307,5
010103,597,837,795,2229,010103,0.26783310901749663,0.3755047106325707,0.3566621803499327,5
010200,5327,6066,10052,21445,010200,0.24840289111681044,0.28286313826066684,0.46873397062252276,6
010201,889,1099,1075,3063,010201,0.2902383284361737,0.35879856349983674,0.35096310806398956,5
010202,981,1159,1150,3290,010202,0.29817629179331306,0.35227963525835865,0.3495440729483283,5
010300,3773,4443,8133,16349,010300,0.23077864089546762,0.27175974065692093,0.4974616184476115,6
010301,677,745,1125,2547,010301,0.26580290537887713,0.29250098154691795,0.4416961130742049,6
010321,344,404,735,1483,010321,0.23196223870532703,0.2724207687120701,0.49561699258260283,6
010322,431,495,967,1893,010322,0.22768092974115162,0.26148969889064977,0.5108293713681986,6
010400,4505,5613,6954,17072,010400,0.26388238050609186,0.32878397375820057,0.4073336457357076,5
010500,4031,4749,8480,17260,010500,0.2335457705677868,0.27514484356894553,0.49130938586326767,6
010501,801,1077,1561,3439,010501,0.23291654550741495,0.31317243384704857,0.4539110206455365,5
010502,836,998,1732,3566,010502,0.23443634324172744,0.2798653954010095,0.485698261357263,6
010503,223,232,527,982,010503,0.22708757637474541,0.23625254582484725,0.5366598778004074,6
010600,3475,4164,5701,13340,010600,0.26049475262368815,0.312143928035982,0.42736131934032984,5
010601,1056,1273,3424,5753,010601,0.1835564053537285,0.22127585607509126,0.5951677385711802,6
010602,1395,1850,3585,6830,010602,0.2042459736456808,0.2708638360175695,0.5248901903367497,6
010700,2817,3458,4842,11117,010700,0.2533957002788522,0.31105514077538904,0.43554915894575874,5
010701,1094,1491,2556,5141,010701,0.21279906632950787,0.29002139661544446,0.49717953705504764,6
010702,1009,1447,2146,4602,010702,0.21925249891351586,0.3144285093437636,0.46631899174272057,5
010703,380,500,433,1313,010703,0.2894135567402894,0.38080731150038083,0.32977913175932977,5
010800,2919,3683,6732,13334,010800,0.21891405429728514,0.27621118944052797,0.5048747562621869,6
010801,1052,1264,2761,5077,010801,0.20720898168209573,0.2489659247587158,0.5438250935591885,6
010802,1023,1084,2427,4534,010802,0.22562858403176003,0.23908248786943095,0.535288928098809,6
010803,1096,1202,2822,5120,010803,0.2140625,0.234765625,0.551171875,6
010804,1225,1273,2633,5131,010804,0.23874488403819918,0.24809978561683882,0.513155330344962,6
010805,830,893,1091,2814,010805,0.294953802416489,0.31734186211798154,0.3877043354655295,5
010807,733,814,837,2384,010807,0.3074664429530201,0.3414429530201342,0.35109060402684567,3
010808,486,696,753,1935,010808,0.25116279069767444,0.35968992248062015,0.3891472868217054,5
010809,504,642,836,1982,010809,0.2542885973763875,0.3239152371342079,0.42179616548940463,5
010900,2212,2637,4541,9390,010900,0.23556975505857294,0.2808306709265176,0.4835995740149095,6
010901,1817,2307,3414,7538,010901,0.2410453701247015,0.30604934996020167,0.4529052799150968,5
010902,2602,3413,5378,11393,010902,0.22838585096111647,0.299569911349074,0.4720442376898095,6
010903,469,618,1155,2242,010903,0.20918822479928637,0.27564674397859057,0.5151650312221231,6
011000,3878,4855,9016,17749,011000,0.21849118260183673,0.27353653726970534,0.507972280128458,6
011001,314,422,409,1145,011001,0.274235807860262,0.3685589519650655,0.3572052401746725,5
011002,424,680,547,1651,011002,0.25681405208964264,0.4118715929739552,0.33131435493640216,5
011011,344,544,707,1595,011011,0.21567398119122258,0.34106583072100316,0.4432601880877743,5
011012,425,605,745,1775,011012,0.23943661971830985,0.3408450704225352,0.4197183098591549,5
011021,391,402,671,1464,011021,0.26707650273224043,0.27459016393442626,0.4583333333333333,6
011022,363,491,620,1474,011022,0.2462686567164179,0.3331071913161465,0.4206241519674355,5
011100,3309,4194,6539,14042,011100,0.23565019228030196,0.29867540236433554,0.4656744053553625,6
011101,1861,2247,4773,8881,011101,0.20954847427091544,0.25301204819277107,0.5374394775363135,6
011102,1721,2409,3852,7982,011102,0.21561012277624655,0.30180405913304936,0.4825858180907041,5
011200,5723,6647,9809,22179,011200,0.2580368817349745,0.2996979124396952,0.44226520582533024,6
011201,1553,1927,3510,6990,011201,0.22217453505007154,0.27567954220314733,0.5021459227467812,6
011202,1222,1356,2740,5318,011202,0.22978563369687852,0.2549830763444904,0.5152312899586311,6
011203,442,470,1172,2084,011203,0.21209213051823417,0.2255278310940499,0.5623800383877159,6
011205,863,803,1594,3260,011205,0.2647239263803681,0.24631901840490797,0.48895705521472393,6
011207,746,834,1254,2834,011207,0.26323218066337334,0.29428369795342274,0.442484121383204,6
011208,731,798,1126,2655,011208,0.2753295668549906,0.30056497175141245,0.424105461393597,5
011231,547,635,947,2129,011231,0.25692813527477687,0.2982620948802255,0.44480976984499765,6
011232,654,722,1287,2663,011232,0.2455876830642133,0.2711227938415321,0.4832895230942546,6
011241,423,350,822,1595,011241,0.2652037617554859,0.219435736677116,0.5153605015673981,6
011242,957,1364,1920,4241,011242,0.2256543268097147,0.32162225890120255,0.45272341428908275,5
011300,3070,3728,6576,13374,011300,0.22954987288769255,0.2787498130701361,0.4917003140421714,6
011301,2643,2741,4541,9925,011301,0.26629722921914356,0.2761712846347607,0.45753148614609573,6
011302,2176,2249,3791,8216,011302,0.26484907497565724,0.2737341772151899,0.46141674780915287,6
011303,653,727,1688,3068,011303,0.21284224250325945,0.23696219035202087,0.5501955671447197,6
011400,4157,4616,7723,16496,011400,0.2520004849660524,0.27982541222114454,0.4681741028128031,6
011401,1521,1685,3770,6976,011401,0.21803325688073394,0.24154243119266056,0.5404243119266054,6
011402,906,1149,2667,4722,011402,0.19186785260482847,0.24332909783989834,0.5648030495552732,6
011403,715,670,1673,3058,011403,0.23381294964028776,0.21909744931327665,0.5470896010464356,6
011404,505,550,1235,2290,011404,0.2205240174672489,0.24017467248908297,0.5393013100436681,6
011405,538,594,1116,2248,011405,0.2393238434163701,0.26423487544483987,0.49644128113879005,6
011500,3022,3584,7492,14098,011500,0.21435664633281318,0.2542204568023833,0.5314228968648035,6
011501,1709,1892,3293,6894,011501,0.2478967217870612,0.2744415433710473,0.4776617348418915,6
011502,1465,1896,1924,5285,011502,0.2771996215704825,0.3587511825922422,0.3640491958372753,5
011503,688,593,1339,2620,011503,0.26259541984732826,0.22633587786259543,0.5110687022900763,6
011504,1484,1899,2812,6195,011504,0.23954802259887006,0.30653753026634384,0.4539144471347861,5
011505,1153,918,1647,3718,011505,0.3101129639591178,0.24690693921463153,0.44298009682625067,2
011506,719,352,372,1443,011506,0.4982674982674983,0.24393624393624394,0.2577962577962578,0
011600,3229,3991,6205,13425,011600,0.24052141527001863,0.29728119180633145,0.4621973929236499,6
011601,1378,1491,2661,5530,011601,0.2491862567811935,0.26962025316455696,0.48119349005424955,6
011602,775,877,1691,3343,011602,0.23182769967095423,0.2623392162728089,0.505833084056237,6
011603,714,857,1401,2972,011603,0.24024226110363392,0.2883580080753701,0.47139973082099595,6
011604,275,237,556,1068,011604,0.25749063670411987,0.22191011235955055,0.5205992509363296,6
011605,249,259,455,963,011605,0.2585669781931464,0.26895119418483904,0.4724818276220145,6
011700,3287,3860,7793,14940,011700,0.22001338688085675,0.2583668005354752,0.521619812583668,6
011701,490,581,947,2018,011701,0.24281466798810702,0.28790882061446976,0.4692765113974232,6
011702,399,495,815,1709,011702,0.2334698654183733,0.2896430661205383,0.47688706846108836,6
011703,956,995,2179,4130,011703,0.2314769975786925,0.24092009685230023,0.5276029055690072,6
011705,616,580,1139,2335,011705,0.2638115631691649,0.24839400428265523,0.4877944325481799,6
011706,532,447,1124,2103,011706,0.25297194484070373,0.21255349500713266,0.5344745601521635,6
011707,770,810,1768,3348,011707,0.22998805256869773,0.24193548387096775,0.5280764635603346,6
011708,479,384,1021,1884,011708,0.25424628450106157,0.20382165605095542,0.5419320594479831,6
011800,5004,5722,11882,22608,011800,0.2213375796178344,0.2530962491153574,0.5255661712668082,6
011801,520,607,875,2002,011801,0.2597402597402597,0.3031968031968032,0.4370629370629371,5
011802,382,360,615,1357,011802,0.2815033161385409,0.26529108327192336,0.45320560058953574,6
011900,3328,3889,5722,12939,011900,0.25720689388669915,0.3005641857948837,0.4422289203184172,5
011901,1526,1579,2655,5760,011901,0.26493055555555556,0.27413194444444444,0.4609375,6
011902,1842,2103,4072,8017,011902,0.22976175626793063,0.2623175751528003,0.5079206685792691,6
011903,241,366,368,975,011903,0.24717948717948718,0.37538461538461537,0.37743589743589745,5
012000,3267,3690,6371,13328,012000,0.2451230492196879,0.27686074429771906,0.478016206482593,6
012001,617,655,889,2161,012001,0.2855159648310967,0.3031004164738547,0.4113836186950486,5
012002,475,474,850,1799,012002,0.264035575319622,0.2634797109505281,0.4724847137298499,6
012003,740,737,1150,2627,012003,0.28169014084507044,0.2805481537875904,0.43776170536733916,6
012100,4079,3801,7630,15510,012100,0.26299161831076723,0.24506769825918762,0.49194068343004516,6
012101,1873,2081,3312,7266,012101,0.257775942747041,0.28640242224057255,0.4558216350123865,6
012102,1979,1957,3112,7048,012102,0.280788876276958,0.2776674233825199,0.44154370034052215,6
012103,1087,1080,1309,3476,012103,0.3127157652474108,0.31070195627157654,0.37658227848101267,3
012105,613,508,673,1794,012105,0.34169453734671124,0.2831661092530658,0.375139353400223,2
012106,472,489,544,1505,012106,0.3136212624584718,0.32491694352159467,0.36146179401993356,3
012200,2652,2917,5833,11402,012200,0.23259077354850027,0.2558323101210314,0.5115769163304683,6
012201,833,906,1608,3347,012201,0.2488795936659695,0.2706901703017628,0.4804302360322677,6
012202,1698,2266,2475,6439,012202,0.2637055443391831,0.35191799968939275,0.3843764559714241,5
012203,420,439,569,1428,012203,0.29411764705882354,0.3074229691876751,0.39845938375350143,5
012204,412,396,535,1343,012204,0.3067758749069248,0.29486224869694716,0.3983618763961281,2
012300,3340,4199,4229,11768,012300,0.2838205302515296,0.3568150917743032,0.35936437797416726,5
012301,1057,979,2641,4677,012301,0.22599957237545434,0.20932221509514645,0.5646782125293992,6
012303,317,353,1299,1969,012303,0.16099542915185372,0.1792788217369223,0.659725749111224,6
012304,775,664,2254,3693,012304,0.2098564852423504,0.17979962090441376,0.6103438938532358,6
012305,465,353,1080,1898,012305,0.24499473129610116,0.18598524762908325,0.5690200210748156,6
012306,491,316,1452,2259,012306,0.217352810978309,0.13988490482514387,0.6427622841965471,6
012400,2252,2745,7097,12094,012400,0.1862080370431619,0.22697205225731767,0.5868199106995204,6
012401,1142,1558,1665,4365,012401,0.2616265750286369,0.35693012600229096,0.38144329896907214,5
012402,1305,1496,2362,5163,012402,0.252760023242301,0.28975401898121245,0.45748595777648654,6
012500,2605,3379,5083,11067,012500,0.23538447637119364,0.30532212885154064,0.4592933947772657,5
012501,1543,1639,2574,5756,012501,0.26806810284920085,0.28474635163307854,0.44718554551772066,6
012502,1295,1459,3171,5925,012502,0.21856540084388185,0.24624472573839662,0.5351898734177215,6
012503,385,323,1174,1882,012503,0.20456960680127523,0.1716259298618491,0.6238044633368757,6
012600,3564,4091,11248,18903,012600,0.18854150134899222,0.21642067396709516,0.5950378246839126,6
012601,579,760,1045,2384,012601,0.24286912751677853,0.3187919463087248,0.43833892617449666,5
012602,530,899,955,2384,012602,0.22231543624161074,0.3770973154362416,0.40058724832214765,5
012700,3499,3744,8235,15478,012700,0.2260627988112159,0.24189171727613387,0.5320454839126502,6
012701,847,1209,1016,3072,012701,0.2757161458333333,0.3935546875,0.3307291666666667,5
012702,730,894,1192,2816,012702,0.25923295454545453,0.3174715909090909,0.42329545454545453,5
012800,3804,4639,8158,16601,012800,0.2291428227215228,0.27944099753026924,0.49141617974820795,6
012801,271,302,292,865,012801,0.3132947976878613,0.3491329479768786,0.3375722543352601,3
012802,712,751,1980,3443,012802,0.20679639848968923,0.21812372930583793,0.5750798722044729,6
012804,388,558,986,1932,012804,0.20082815734989648,0.2888198757763975,0.510351966873706,6
012805,360,414,835,1609,012805,0.22374145431945308,0.25730267246737104,0.5189558732131759,6
012806,642,841,1451,2934,012806,0.21881390593047034,0.28663940013633266,0.494546693933197,6
012900,2933,3365,6357,12655,012900,0.23176610035559067,0.2659028052153299,0.5023310944290794,6
012901,1663,2128,2446,6237,012901,0.2666345999679333,0.34118967452300786,0.3921757255090588,5
012902,732,773,1499,3004,012902,0.2436750998668442,0.25732356857523303,0.49900133155792276,6
013000,3874,4519,8401,16794,013000,0.23067762296058117,0.26908419673692985,0.500238180302489,6
013001,1440,1598,2190,5228,013001,0.2754399387911247,0.30566182096403977,0.4188982402448355,5
013002,1888,2084,3820,7792,013002,0.24229979466119098,0.26745379876796715,0.4902464065708419,6
013003,253,222,732,1207,013003,0.20961060480530241,0.18392709196354598,0.6064623032311516,6
013100,3757,4521,8032,16310,013100,0.23034947884733292,0.2771919068056407,0.49245861434702637,6
013101,1578,1970,2710,6258,013101,0.2521572387344199,0.3147970597635027,0.43304570150207733,5
013102,1667,1633,3778,7078,013102,0.23551850805312236,0.23071489121220684,0.5337666007346709,6
013103,758,736,1908,3402,013103,0.22281011169900058,0.21634332745443857,0.5608465608465608,6
013104,1094,1189,2164,4447,013104,0.24600854508657521,0.2673712615246233,0.4866201933888014,6
013200,2450,3077,7439,12966,013200,0.1889557303717415,0.23731297238932592,0.5737312972389326,6
013201,2183,2418,4544,9145,013201,0.23870967741935484,0.26440677966101694,0.4968835429196282,6
013202,1651,1721,3234,6606,013202,0.24992431123221315,0.2605207387223736,0.4895549500454133,6
013203,1338,1429,2514,5281,013203,0.25336110585116456,0.2705926907782617,0.47604620337057374,6
013204,1413,1734,3005,6152,013204,0.2296814044213264,0.2818595578673602,0.4884590377113134,6
013205,560,633,796,1989,013205,0.2815485168426345,0.31825037707390647,0.40020110608345905,5
013206,580,780,1230,2590,013206,0.22393822393822393,0.30115830115830117,0.4749034749034749,5
013300,4602,5242,9651,19495,013300,0.23606052834060015,0.2688894588355989,0.49505001282380096,6
013301,989,1369,1340,3698,013301,0.26744186046511625,0.3702001081665765,0.3623580313683072,5
013302,349,412,535,1296,013302,0.2692901234567901,0.31790123456790126,0.41280864197530864,5
013303,438,549,749,1736,013303,0.2523041474654378,0.3162442396313364,0.4314516129032258,5
013304,1079,1301,2059,4439,013304,0.24307276413606668,0.2930840279342194,0.4638432079297139,6
013400,5066,6270,13440,24776,013400,0.20447206974491444,0.25306748466257667,0.5424604455925088,6
013401,954,1097,1701,3752,013401,0.2542643923240938,0.2923773987206823,0.4533582089552239,6
013402,765,801,1583,3149,013402,0.24293426484598285,0.25436646554461734,0.5026992696093998,6
013500,3613,4186,8002,15801,013500,0.2286564141510031,0.264919941775837,0.5064236440731599,6
013501,793,869,1586,3248,013501,0.2441502463054187,0.26754926108374383,0.4883004926108374,6
013502,732,609,1707,3048,013502,0.24015748031496062,0.19980314960629922,0.5600393700787402,6
013503,1066,1363,2187,4616,013503,0.23093587521663778,0.2952772963604853,0.47378682842287695,6
013505,749,972,1176,2897,013505,0.25854332067656194,0.33551950293406974,0.4059371763893683,5
013506,1506,1905,3059,6470,013506,0.23276661514683153,0.294435857805255,0.47279752704791345,6
013507,1172,1123,1844,4139,013507,0.2831601836192317,0.27132157525972456,0.4455182411210437,6
013508,1016,1181,2427,4624,013508,0.21972318339100347,0.2554065743944637,0.5248702422145328,6
013600,3457,4195,10489,18141,013600,0.1905628135163442,0.23124414310126234,0.5781930433823935,6
013601,1222,1673,2275,5170,013601,0.23636363636363636,0.32359767891682784,0.4400386847195358,5
013602,307,469,922,1698,013602,0.18080094228504123,0.2762073027090695,0.5429917550058893,6
013603,635,667,1037,2339,013603,0.271483539974348,0.2851646002565199,0.4433518597691321,6
013604,587,701,819,2107,013604,0.2785951589938301,0.33270052206929285,0.38870431893687707,5
013700,2051,2295,6251,10597,013700,0.1935453430216099,0.216570727564405,0.589883929413985,6
013701,1771,2180,2487,6438,013701,0.27508543025784404,0.338614476545511,0.38630009319664493,5
013702,1111,1167,2002,4280,013702,0.25957943925233645,0.27266355140186915,0.4677570093457944,6
013703,183,235,431,849,013703,0.21554770318021202,0.2767962308598351,0.5076560659599529,6
013705,666,772,1465,2903,013705,0.22941784361005857,0.26593179469514294,0.5046503616947985,6
013706,189,217,519,925,013706,0.20432432432432432,0.23459459459459459,0.5610810810810811,6
013707,497,570,1330,2397,013707,0.20734251147267418,0.23779724655819776,0.5548602419691281,6
013800,5465,6227,13888,25580,013800,0.21364347146207974,0.24343236903831117,0.542924159499609,6
013801,731,1027,1467,3225,013801,0.22666666666666666,0.31844961240310077,0.45488372093023255,5
013802,454,518,1178,2150,013802,0.2111627906976744,0.24093023255813953,0.5479069767441861,6
013900,3296,3372,8640,15308,013900,0.21531225503004964,0.22027697935719884,0.5644107656127515,6
013901,730,1137,1108,2975,013901,0.2453781512605042,0.38218487394957984,0.37243697478991594,5
013902,1094,1531,1518,4143,013902,0.2640598600048274,0.369538981414434,0.3664011585807386,5
014000,2776,3195,6407,12378,014000,0.2242688641137502,0.2581192438196801,0.5176118920665698,6
014001,943,1236,1627,3806,014001,0.24776668418286915,0.324750394114556,0.4274829217025749,5
014002,459,716,821,1996,014002,0.22995991983967937,0.3587174348697395,0.41132264529058116,5
014003,551,767,648,1966,014003,0.280264496439471,0.3901322482197355,0.3296032553407935,5
014004,643,735,709,2087,014004,0.3080977479635841,0.35218016291327264,0.3397220891231433,3
014100,3002,3888,5929,12819,014100,0.23418363366877293,0.3032997893751463,0.46251657695608084,5
014101,1226,1380,2451,5057,014101,0.2424362270120625,0.2728890646628436,0.4846747083250939,6
014102,1792,2031,3210,7033,014102,0.2547988056305986,0.2887814588369117,0.4564197355324897,6
014103,694,841,991,2526,014103,0.2747426761678543,0.3329374505146477,0.392319873317498,5
014104,573,624,838,2035,014104,0.28157248157248155,0.30663390663390666,0.4117936117936118,5
014200,1960,2555,4105,8620,014200,0.2273781902552204,0.29640371229698376,0.4762180974477958,6
014201,1221,1544,2822,5587,014201,0.2185430463576159,0.2763558260247002,0.5051011276176839,6
014202,2301,2683,4528,9512,014202,0.2419049621530698,0.28206476030277544,0.4760302775441548,6
014203,1455,1937,2865,6257,014203,0.23253955569761867,0.30957327792871986,0.4578871663736615,5
014204,906,1093,1593,3592,014204,0.2522271714922049,0.3042873051224944,0.4434855233853007,5
014206,944,802,2118,3864,014206,0.2443064182194617,0.20755693581780538,0.5481366459627329,6
014207,736,744,1373,2853,014207,0.25797406239046616,0.2607781282860147,0.4812478093235191,6
014208,641,665,1250,2556,014208,0.25078247261345854,0.26017214397496086,0.4890453834115806,6
014209,654,642,1195,2491,014209,0.2625451625853071,0.2577278201525492,0.47972701726214373,6
014300,2887,3553,4785,11225,014300,0.25719376391982185,0.3165256124721604,0.42628062360801783,5
014301,1967,2364,3393,7724,014301,0.2546607975142413,0.3060590367685137,0.43928016571724493,5
014302,3117,3365,5888,12370,014302,0.25198059822150365,0.27202910266774455,0.4759902991107518,6
014400,4875,5995,7589,18459,014400,0.2640988135868682,0.32477382306733843,0.41112736334579336,5
014401,595,781,2292,3668,014401,0.16221374045801526,0.21292257360959652,0.6248636859323882,6
014402,725,945,3164,4834,014402,0.14997931319817956,0.19549027720314438,0.654530409598676,6
014500,3660,4417,7394,15471,014500,0.23657165018421564,0.2855019067933553,0.47792644302242904,6
014501,2100,2428,3794,8322,014501,0.25234318673395817,0.29175678923335735,0.4559000240326844,6
014502,1407,1685,2809,5901,014502,0.23843416370106763,0.28554482291137095,0.4760210133875614,6
014503,862,987,1623,3472,014503,0.24827188940092165,0.2842741935483871,0.4674539170506912,6
014504,807,915,1378,3100,014504,0.2603225806451613,0.29516129032258065,0.44451612903225807,6
014505,702,842,902,2446,014505,0.28699918233851185,0.34423548650858543,0.3687653311529027,5
014600,2149,2317,3674,8140,014600,0.264004914004914,0.28464373464373466,0.45135135135135135,6
014601,1651,1775,4409,7835,014601,0.210721123165284,0.2265475430759413,0.5627313337587747,6
014602,1123,1181,4069,6373,014602,0.1762121449866625,0.18531303938490506,0.6384748156284324,6
014603,548,445,1170,2163,014603,0.25335182616736013,0.20573277854831254,0.5409153952843273,6
014604,2162,2081,4747,8990,014604,0.24048943270300333,0.2314794215795328,0.5280311457174639,6
014605,699,760,1850,3309,014605,0.2112420670897552,0.22967663946811726,0.5590812934421275,6
014606,1620,1696,4389,7705,014606,0.21025308241401688,0.22011680726800778,0.5696301103179754,6
014607,2186,2204,5159,9549,014607,0.22892449471148812,0.23080950884909415,0.5402659964394178,6
014608,1048,1115,2059,4222,014608,0.2482235907153008,0.26409284699194696,0.4876835622927522,6
014609,716,810,1662,3188,014609,0.2245922208281054,0.25407779171894607,0.5213299874529486,6
014611,266,316,598,1180,014611,0.22542372881355932,0.2677966101694915,0.5067796610169492,6
014612,225,226,446,897,014612,0.2508361204013378,0.25195094760312153,0.4972129319955407,6
014613,400,534,897,1831,014613,0.2184598580010923,0.2916439104314582,0.4898962315674495,6
014614,818,838,1758,3414,014614,0.239601640304628,0.2454598711189221,0.5149384885764499,6
014615,300,337,734,1371,014615,0.2188183807439825,0.24580598103574033,0.5353756382202771,6
014700,3164,3523,7683,14370,014700,0.22018093249826026,0.24516353514265832,0.5346555323590814,6
014701,1929,2227,3019,7175,014701,0.26885017421602786,0.31038327526132403,0.4207665505226481,5
014702,1489,1599,1983,5071,014702,0.29363044764346286,0.31532242161309404,0.3910471307434431,5
014703,581,646,1520,2747,014703,0.21150345831816528,0.23516563523844194,0.5533309064433928,6
014704,218,287,586,1091,014704,0.1998166819431714,0.26306141154903756,0.537121906507791,6
014800,1265,1387,2527,5179,014800,0.24425564780845724,0.2678123189804982,0.4879320332110446,6
014801,978,1150,2232,4360,014801,0.22431192660550459,0.26376146788990823,0.5119266055045871,6
014802,1257,1493,3801,6551,014802,0.19187910242711037,0.22790413677301175,0.5802167607998778,6
014803,1717,2049,2962,6728,014803,0.2552021403091558,0.30454815695600473,0.4402497027348395,5
014804,1923,2083,3889,7895,014804,0.2435718809373021,0.26383787207093096,0.49259024699176696,6
014805,358,347,1209,1914,014805,0.18704284221525602,0.1812957157784744,0.6316614420062696,6
014806,606,588,1801,2995,014806,0.2023372287145242,0.1963272120200334,0.6013355592654424,6
014808,293,316,1045,1654,014808,0.17714631197097944,0.19105199516324062,0.6318016928657799,6
014809,533,577,1748,2858,014809,0.18649405178446465,0.20188943317004898,0.6116165150454863,6
014810,200,165,492,857,014810,0.23337222870478413,0.19253208868144692,0.574095682613769,6
014811,511,496,1677,2684,014811,0.19038748137108794,0.18479880774962743,0.6248137108792846,6
014900,2005,2260,5639,9904,014900,0.20244345718901455,0.22819063004846526,0.5693659127625202,6
014901,1683,1989,3826,7498,014901,0.22445985596158977,0.265270738863697,0.5102694051747133,6
014903,1929,2073,3715,7717,014903,0.24996760399118828,0.2686277050667358,0.48140469094207594,6
014904,51,32,29,112,014904,0.45535714285714285,0.2857142857142857,0.25892857142857145,0
014905,781,814,1214,2809,014905,0.27803488786044855,0.28978284086863654,0.4321822712709149,6
014906,533,545,817,1895,014906,0.2812664907651715,0.287598944591029,0.43113456464379946,6
014907,378,400,1348,2126,014907,0.17779868297271872,0.18814675446848542,0.6340545625587959,6
014908,233,242,823,1298,014908,0.17950693374422189,0.1864406779661017,0.6340523882896765,6
014909,311,318,855,1484,014909,0.2095687331536388,0.21428571428571427,0.5761455525606469,6
015000,2031,2183,4126,8340,015000,0.2435251798561151,0.2617505995203837,0.4947242206235012,6
015001,923,950,1932,3805,015001,0.24257555847568987,0.24967148488830487,0.5077529566360053,6
015002,629,666,2044,3339,015002,0.18837975441749027,0.19946091644204852,0.6121593291404612,6
015003,943,907,1158,3008,015003,0.3134973404255319,0.3015292553191489,0.3849734042553192,3
015004,822,616,702,2140,015004,0.3841121495327103,0.28785046728971964,0.3280373831775701,2
015005,437,405,453,1295,015005,0.33745173745173745,0.3127413127413127,0.3498069498069498,3
015006,690,572,757,2019,015006,0.34175334323922735,0.283308568598316,0.37493808816245666,2
015100,3621,4364,8262,16247,015100,0.2228719148150428,0.26860343448021173,0.5085246507047455,6
015101,1031,1273,1617,3921,015101,0.2629431267533792,0.32466207600102015,0.41239479724560063,5
015102,767,1130,1118,3015,015102,0.2543946932006633,0.3747927031509121,0.37081260364842455,5
015200,3213,3921,7573,14707,015200,0.21846739647786767,0.2666077378119263,0.514924865710206,6
015201,800,830,1408,3038,015201,0.2633311389071758,0.27320605661619485,0.46346280447662935,6
015202,1108,1050,1940,4098,015202,0.27037579306979015,0.2562225475841874,0.47340165934602246,6
015203,261,260,583,1104,015203,0.23641304347826086,0.23550724637681159,0.5280797101449275,6
015300,1466,1651,5300,8417,015300,0.17417131994772483,0.19615064749910896,0.6296780325531662,6
015301,949,947,1352,3248,015301,0.29217980295566504,0.291564039408867,0.41625615763546797,6
015302,475,509,728,1712,015302,0.2774532710280374,0.2973130841121495,0.4252336448598131,6
015303,364,404,528,1296,015303,0.2808641975308642,0.3117283950617284,0.4074074074074074,5
015304,538,548,514,1600,015304,0.33625,0.3425,0.32125,3
015400,2105,2767,7009,11881,015400,0.1771736385826109,0.23289285413685717,0.589933507280532,6
015401,481,608,646,1735,015401,0.27723342939481266,0.3504322766570605,0.3723342939481268,5
015402,777,868,1243,2888,015402,0.2690443213296399,0.30055401662049863,0.4304016620498615,5
015500,1777,1814,5979,9570,015500,0.18568443051201672,0.1895506792058516,0.6247648902821317,6
015501,383,416,457,1256,015501,0.3049363057324841,0.33121019108280253,0.3638535031847134,3
015503,393,494,581,1468,015503,0.2677111716621253,0.33651226158038144,0.3957765667574932,5
015504,595,741,863,2199,015504,0.2705775352432924,0.3369713506139154,0.39245111414279216,5
015600,540,876,845,2261,015600,0.23883237505528526,0.3874391862007961,0.37372843874391865,5
015601,1284,1643,4422,7349,015601,0.1747176486596816,0.22356783235814395,0.6017145189821744,6
015602,578,631,1413,2622,015602,0.2204424103737605,0.2406559877955759,0.5389016018306636,6
015603,410,514,1078,2002,015603,0.2047952047952048,0.25674325674325676,0.5384615384615384,6
015700,3256,3403,8191,14850,015700,0.21925925925925926,0.22915824915824917,0.5515824915824916,6
015800,1389,1597,2284,5270,015800,0.2635673624288425,0.3030360531309298,0.4333965844402277,5
015801,531,802,2326,3659,015801,0.14512161792839573,0.2191855698278218,0.6356928122437825,6
015802,551,1077,1833,3461,015802,0.15920254261774053,0.3111817393816816,0.5296157180005778,5
015900,2422,2572,7304,12298,015900,0.1969425922914295,0.20913969751179054,0.59391771019678,6
016000,764,986,1892,3642,016000,0.2097748489840747,0.27073036792970895,0.5194947830862163,6
016001,766,911,2077,3754,016001,0.20404901438465636,0.24267448055407564,0.553276505061268,6
016002,731,832,1893,3456,016002,0.2115162037037037,0.24074074074074073,0.5477430555555556,6
016100,2145,2553,5564,10262,016100,0.20902358214772948,0.24878191385694795,0.5421945039953225,6
016200,1958,2627,3010,7595,016200,0.2578011849901251,0.3458854509545754,0.39631336405529954,5
016300,2741,2806,6183,11730,016300,0.23367433930093776,0.23921568627450981,0.5271099744245524,6
016400,1852,2611,2728,7191,016400,0.25754415241273815,0.3630927548324294,0.37936309275483243,5
016500,1129,1146,4536,6811,016500,0.16576126853619144,0.16825723094993392,0.6659815005138746,6
016501,216,241,369,826,016501,0.26150121065375304,0.2917675544794189,0.4467312348668281,6
016502,493,501,878,1872,016502,0.26335470085470086,0.2676282051282051,0.469017094017094,6
016600,2530,3142,4295,9967,016600,0.25383766429216414,0.3152402929667904,0.43092204274104545,5
016700,1940,2205,5223,9368,016700,0.20708795900939367,0.23537574722459437,0.557536293766012,6
016800,1148,1781,1701,4630,016800,0.24794816414686824,0.38466522678185744,0.3673866090712743,5
016801,159,179,269,607,016801,0.26194398682042835,0.29489291598023065,0.443163097199341,6
016802,254,324,473,1051,016802,0.241674595623216,0.3082778306374881,0.45004757373929594,5
016900,2132,2403,6002,10537,016900,0.20233463035019456,0.2280535256714435,0.569611843978362,6
016901,542,684,1290,2516,016901,0.21542130365659778,0.2718600953895072,0.5127186009538951,6
016902,257,254,343,854,016902,0.3009367681498829,0.297423887587822,0.4016393442622951,2
017000,1512,2048,2180,5740,017000,0.2634146341463415,0.356794425087108,0.3797909407665505,5
017005,410,483,1122,2015,017005,0.20347394540942929,0.23970223325062034,0.5568238213399503,6
017007,356,438,1055,1849,017007,0.19253650621957816,0.23688480259599784,0.5705786911844241,6
017008,655,689,1727,3071,017008,0.21328557473135787,0.22435688700748943,0.5623575382611528,6
017009,372,428,1022,1822,017009,0.20417124039517015,0.2349066959385291,0.5609220636663008,6
017010,737,869,1921,3527,017010,0.20895945562801246,0.24638502977034307,0.5446555146016444,6
017011,415,429,1088,1932,017011,0.21480331262939958,0.2220496894409938,0.5631469979296067,6
017012,347,368,980,1695,017012,0.20471976401179942,0.21710914454277286,0.5781710914454278,6
017100,1527,1611,4236,7374,017100,0.20707892595606184,0.21847030105777054,0.5744507729861676,6
017200,1426,1974,1984,5384,017200,0.2648588410104012,0.3666419019316493,0.3684992570579495,5
017300,2432,2839,5102,10373,017300,0.23445483466692374,0.2736913139882387,0.49185385134483756,6
017400,857,1100,1032,2989,017400,0.2867179658748745,0.36801605888256944,0.34526597524255603,5
017401,447,612,687,1746,017401,0.25601374570446733,0.35051546391752575,0.39347079037800686,5
017402,277,283,441,1001,017402,0.27672327672327673,0.2827172827172827,0.4405594405594406,6
017500,1247,1627,3327,6201,017500,0.2010965973230124,0.2623770359619416,0.5365263667150459,6
017501,274,266,303,843,017501,0.3250296559905101,0.3155397390272835,0.3594306049822064,3
017502,409,367,534,1310,017502,0.31221374045801525,0.28015267175572517,0.4076335877862595,2
017600,789,1093,1858,3740,017600,0.2109625668449198,0.2922459893048128,0.49679144385026736,6
017700,1472,1668,4182,7322,017700,0.2010379677683693,0.22780661021578805,0.5711554220158427,6
017701,410,580,301,1291,017701,0.3175832687838885,0.4492641363284276,0.23315259488768397,1
017702,431,642,363,1436,017702,0.30013927576601673,0.44707520891364905,0.2527855153203343,1
017800,759,1218,1268,3245,017800,0.23389830508474577,0.375346687211094,0.3907550077041603,5
017900,1166,1313,3917,6396,017900,0.18230143839899937,0.20528455284552846,0.6124140087554721,6
017901,541,781,418,1740,017901,0.31091954022988505,0.44885057471264367,0.24022988505747125,1
017902,415,568,274,1257,017902,0.33015115354017505,0.4518695306284805,0.21797931583134447,1
018000,1176,1468,1511,4155,018000,0.28303249097472927,0.353309265944645,0.3636582430806258,5
018100,1316,1446,4878,7640,018100,0.17225130890052356,0.1892670157068063,0.6384816753926702,6
018101,678,949,989,2616,018101,0.2591743119266055,0.3627675840978593,0.3780581039755352,5
018102,911,1277,1274,3462,018102,0.26314269208549973,0.3688619295205084,0.36799537839399193,5
018200,1187,1628,1441,4256,018200,0.2789003759398496,0.3825187969924812,0.3385808270676692,5
018300,1296,1514,4625,7435,018300,0.17431069266980498,0.20363147276395427,0.6220578345662408,6
018301,429,668,613,1710,018301,0.25087719298245614,0.3906432748538012,0.3584795321637427,5
018302,413,605,390,1408,018302,0.29332386363636365,0.4296875,0.27698863636363635,4
018400,1271,1750,2410,5431,018400,0.23402688271036642,0.32222426809059107,0.44374884919904256,5
018401,173,274,246,693,018401,0.24963924963924963,0.3953823953823954,0.354978354978355,5
018402,162,304,272,738,018402,0.21951219512195122,0.41192411924119243,0.3685636856368564,5
018500,1078,1456,2257,4791,018500,0.22500521811730329,0.30390315174285115,0.47109163013984556,5
018501,707,994,1228,2929,018501,0.2413793103448276,0.33936497097985663,0.4192557186753158,5
018502,306,385,679,1370,018502,0.22335766423357664,0.28102189781021897,0.49562043795620436,6
018600,864,1180,1218,3262,018600,0.26486817903126914,0.36174126302881665,0.37339055793991416,5
018700,1175,1265,3455,5895,018700,0.1993214588634436,0.21458863443596268,0.5860899067005937,6
018701,205,264,489,958,018701,0.2139874739039666,0.2755741127348643,0.5104384133611691,6
018702,736,931,1775,3442,018702,0.2138291690877397,0.2704822777454968,0.5156885531667635,6
018800,983,1293,1427,3703,018800,0.2654604374831218,0.349176343505266,0.3853632190116122,5
018900,2060,2728,3232,8020,018900,0.256857855361596,0.34014962593516207,0.4029925187032419,5
018901,533,630,1307,2470,018901,0.21578947368421053,0.2550607287449393,0.5291497975708502,6
018902,470,664,1169,2303,018902,0.20408163265306123,0.2883195831524099,0.5075987841945289,6
019000,928,1293,1548,3769,019000,0.24621915627487398,0.3430618201114354,0.4107190236136906,5
019100,1033,955,3255,5243,019100,0.19702460423421705,0.1821476254053023,0.6208277703604806,6
019200,890,1056,934,2880,019200,0.3090277777777778,0.36666666666666664,0.32430555555555557,3
019300,1938,2488,3242,7668,019300,0.25273865414710484,0.32446531038080334,0.4227960354720918,5
019400,1547,2201,1951,5699,019400,0.27145113177750485,0.3862081066853834,0.3423407615371118,5
019500,1868,2410,4147,8425,019500,0.22172106824925816,0.286053412462908,0.4922255192878338,6
019600,1163,1487,1546,4196,019600,0.27716873212583415,0.3543851286939943,0.3684461391801716,5
019700,1279,1777,2333,5389,019700,0.2373353126739655,0.329745778437558,0.4329189088884765,5
019701,75,73,185,333,019701,0.22522522522522523,0.21921921921921922,0.5555555555555556,6
019702,299,326,647,1272,019702,0.235062893081761,0.2562893081761006,0.5086477987421384,6
019800,1227,1533,2841,5601,019800,0.21906802356722013,0.273701124799143,0.5072308516336369,6
019900,2045,2595,3863,8503,019900,0.24050335175820298,0.3051864047983065,0.4543102434434905,5
020000,1000,1281,1593,3874,020000,0.2581311306143521,0.330665978316985,0.41120289106866287,5
020003,560,581,1099,2240,020003,0.25,0.259375,0.490625,6
020004,352,350,675,1377,020004,0.25562817719680464,0.2541757443718228,0.49019607843137253,6
020005,603,669,1241,2513,020005,0.23995224830879427,0.2662156784719459,0.49383207321925987,6
020100,3262,4104,5475,12841,020100,0.25403005996417727,0.31960127715909975,0.426368662876723,5
020101,1335,1483,2612,5430,020101,0.24585635359116023,0.2731123388581952,0.48103130755064455,6
020102,1785,2267,2702,6754,020102,0.26428782943440926,0.33565294640213206,0.4000592241634587,5
020200,2960,3584,3676,10220,020200,0.2896281800391389,0.3506849315068493,0.35968688845401176,5
020201,630,731,1075,2436,020201,0.25862068965517243,0.30008210180623973,0.44129720853858784,5
020202,539,620,1214,2373,020202,0.22713864306784662,0.2612726506531816,0.5115887062789718,6
020300,2552,2649,3616,8817,020300,0.2894408528978111,0.3004423273222184,0.4101168197799705,5
020301,850,1084,1252,3186,020301,0.2667922159447583,0.34023854362837413,0.39296924042686754,5
020302,1267,1507,1991,4765,020302,0.265897166841553,0.3162644281217209,0.41783840503672615,5
020400,1696,2198,2456,6350,020400,0.2670866141732283,0.34614173228346456,0.38677165354330706,5
020401,1011,1248,1593,3852,020401,0.26246105919003115,0.32398753894080995,0.4135514018691589,5
020402,868,1077,1395,3340,020402,0.25988023952095807,0.3224550898203593,0.4176646706586826,5
020500,3597,4475,6349,14421,020500,0.2494279176201373,0.31031135150128286,0.44026073087857986,5
020501,620,1078,548,2246,020501,0.27604630454140694,0.47996438112199463,0.2439893143365984,4
020502,183,363,242,788,020502,0.23223350253807107,0.4606598984771574,0.30710659898477155,5
020600,3048,4219,4584,11851,020600,0.2571934857817906,0.3560037127668551,0.3868028014513543,5
020601,295,441,454,1190,020601,0.24789915966386555,0.37058823529411766,0.3815126050420168,5
020700,2849,3574,4207,10630,020700,0.2680150517403575,0.3362182502351834,0.3957666980244591,5
020701,1212,1534,1918,4664,020701,0.25986277873070324,0.32890222984562606,0.41123499142367065,5
020702,841,1197,1160,3198,020702,0.26297686053783614,0.37429643527204504,0.3627267041901188,5
020703,918,1389,1300,3607,020703,0.2545051289159967,0.3850845578042695,0.36041031327973383,5
020705,226,383,237,846,020705,0.26713947990543735,0.45271867612293143,0.2801418439716312,4
020800,2541,3161,3325,9027,020800,0.28148886673313395,0.35017170710091944,0.3683394261659466,5
020801,745,866,2136,3747,020801,0.19882572724846545,0.23111822791566586,0.5700560448358687,6
020802,396,537,179,1112,020802,0.35611510791366907,0.4829136690647482,0.16097122302158273,1
020803,760,959,1504,3223,020803,0.2358051504809184,0.2975488675147378,0.46664598200434376,6
020804,432,529,1146,2107,020804,0.20503084954912199,0.2510678690080683,0.5439012814428097,6
020900,2132,2804,1730,6666,020900,0.31983198319831985,0.42064206420642064,0.2595259525952595,1
020901,684,943,761,2388,020901,0.2864321608040201,0.39489112227805695,0.31867671691792293,5
020902,577,801,987,2365,020902,0.24397463002114164,0.3386892177589852,0.41733615221987314,5
021000,3138,4012,4064,11214,021000,0.279828785446763,0.3577670768682005,0.36240413768503654,5
021001,1002,1499,1741,4242,021001,0.2362093352192362,0.3533710513908534,0.4104196133899104,5
021002,1062,1442,1667,4171,021002,0.2546152001918005,0.3457204507312395,0.39966434907695997,5
021100,2568,3197,3623,9388,021100,0.2735406902428632,0.3405411163187047,0.38591819343843203,5
021101,453,608,412,1473,021101,0.3075356415478615,0.41276306856754924,0.27970128988458925,1
021102,504,609,351,1464,021102,0.3442622950819672,0.41598360655737704,0.23975409836065573,1
021103,389,634,593,1616,021103,0.2407178217821782,0.39232673267326734,0.36695544554455445,5
021104,261,352,337,950,021104,0.27473684210526317,0.3705263157894737,0.3547368421052632,5
021200,4014,5026,5233,14273,021200,0.2812302949625166,0.35213339872486515,0.36663630631261823,5
021201,211,334,86,631,021201,0.33438985736925514,0.5293185419968305,0.13629160063391443,1
021202,303,474,193,970,021202,0.31237113402061856,0.488659793814433,0.19896907216494844,1
021300,1625,2288,2439,6352,021300,0.2558249370277078,0.3602015113350126,0.3839735516372796,5
021301,502,609,470,1581,021301,0.31752055660974066,0.38519924098671726,0.2972802024035421,1
021302,912,1485,810,3207,021302,0.284377923292797,0.4630495790458372,0.25257249766136575,4
021303,974,1279,1281,3534,021303,0.27560837577815506,0.3619128466327108,0.3624787775891341,5
021400,2224,2761,3056,8041,021400,0.27658251461261035,0.3433652530779754,0.38005223230941426,5
021401,807,1072,1022,2901,021401,0.2781799379524302,0.369527749052051,0.3522923129955188,5
021402,386,566,498,1450,021402,0.26620689655172414,0.3903448275862069,0.34344827586206894,5
021500,1546,2171,2645,6362,021500,0.2430053442313738,0.34124489154353976,0.41574976422508647,5
021501,945,1339,1064,3348,021501,0.28225806451612906,0.39994026284348866,0.31780167264038234,5
021502,1681,2314,1907,5902,021502,0.2848187055235513,0.3920704845814978,0.3231108098949509,5
021600,2521,3276,3952,9749,021600,0.2585906246794543,0.33603446507334084,0.40537491024720484,5
021601,1319,1813,1564,4696,021601,0.2808773424190801,0.3860732538330494,0.3330494037478705,5
021602,1246,1639,1863,4748,021602,0.2624262847514743,0.3451979780960404,0.39237573715248525,5
021603,419,458,644,1521,021603,0.2754766600920447,0.30111768573307035,0.42340565417488496,5
021604,378,431,446,1255,021604,0.301195219123506,0.3434262948207171,0.3553784860557769,3
021605,411,513,321,1245,021605,0.3301204819277108,0.41204819277108434,0.25783132530120484,1
021700,1974,3065,2469,7508,021700,0.2629195524773575,0.4082312200319659,0.32884922749067663,5
021701,402,457,625,1484,021701,0.27088948787061995,0.3079514824797844,0.4211590296495957,5
021702,347,541,408,1296,021702,0.26774691358024694,0.4174382716049383,0.3148148148148148,5
021703,33,47,52,132,021703,0.25,0.3560606060606061,0.3939393939393939,5
021800,2823,3498,3969,10290,021800,0.2743440233236152,0.33994169096209914,0.38571428571428573,5
021900,1554,2071,1759,5384,021900,0.28863298662704306,0.3846582466567608,0.32670876671619614,5
022000,2240,2685,2533,7458,022000,0.3003486189326897,0.3600160901045857,0.3396352909627246,3
022001,370,536,1144,2050,022001,0.18048780487804877,0.26146341463414635,0.5580487804878049,6
022002,386,573,1058,2017,022002,0.19137332672285573,0.2840852751611304,0.5245413981160139,6
022100,1016,1472,1528,4016,022100,0.25298804780876494,0.3665338645418327,0.3804780876494024,5
022101,416,649,323,1388,022101,0.29971181556195964,0.4675792507204611,0.23270893371757925,4
022102,730,1013,888,2631,022102,0.27746104142911443,0.38502470543519574,0.33751425313568983,5
022200,2053,2298,2705,7056,022200,0.29095804988662133,0.32568027210884354,0.38336167800453513,5
022300,1207,1734,1400,4341,022300,0.27804653305689936,0.39944713199723564,0.322506334945865,5
022301,895,1197,1003,3095,022301,0.28917609046849757,0.38675282714054926,0.32407108239095317,5
022302,443,545,610,1598,022302,0.2772215269086358,0.34105131414267836,0.38172715894868586,5
022400,1727,2214,1768,5709,022400,0.302504816955684,0.3878087230688387,0.30968645997547734,3
022401,462,711,771,1944,022401,0.23765432098765432,0.36574074074074076,0.3966049382716049,5
022403,266,428,498,1192,022403,0.2231543624161074,0.35906040268456374,0.41778523489932884,5
022404,324,573,716,1613,022404,0.20086794792312462,0.35523868567885925,0.44389336639801613,5
022500,2917,4251,3108,10276,022500,0.28386531724406383,0.41368236667964187,0.3024523160762943,5
022600,1435,1673,2769,5877,022600,0.2441721966989961,0.28466904883443933,0.4711587544665646,6
022601,347,441,314,1102,022601,0.31488203266787657,0.40018148820326677,0.2849364791288566,1
022602,1051,1193,1094,3338,022602,0.3148591971240264,0.35739964050329537,0.32774116237267825,3
022700,840,1153,1549,3542,022700,0.23715415019762845,0.3255223037831734,0.4373235460191982,5
022701,936,1164,959,3059,022701,0.3059823471722785,0.38051650866296177,0.3135011441647597,3
022702,1975,2258,3248,7481,022702,0.2640021387515038,0.301831305975137,0.4341665552733592,5
022703,167,339,221,727,022703,0.2297111416781293,0.46629986244841815,0.30398899587345257,5
022711,1555,1539,2143,5237,022711,0.2969257208325377,0.2938705365667367,0.4092037426007256,6
022712,1294,1445,1898,4637,022712,0.27905973689885705,0.31162389475954283,0.4093163683416002,5
022800,1981,2546,2760,7287,022800,0.27185398655139287,0.34938932345272405,0.3787566899958831,5
022803,606,676,780,2062,022803,0.2938894277400582,0.32783705140640157,0.37827352085354027,5
022804,380,529,647,1556,022804,0.2442159383033419,0.33997429305912596,0.4158097686375321,5
022900,1441,1974,2238,5653,022900,0.25490889793030247,0.3491951176366531,0.3958959844330444,5
022901,817,1176,712,2705,022901,0.3020332717190388,0.43475046210720886,0.2632162661737523,1
022902,776,1069,815,2660,022902,0.29172932330827067,0.4018796992481203,0.30639097744360905,5
023000,2644,3374,3362,9380,023000,0.28187633262260126,0.3597014925373134,0.35842217484008526,5
023001,260,380,259,899,023001,0.289210233592881,0.42269187986651835,0.28809788654060065,4
023100,2027,2710,3253,7990,023100,0.2536921151439299,0.33917396745932415,0.4071339173967459,5
023200,3414,3930,3665,11009,023200,0.3101099100735762,0.3569806521936597,0.3329094377327641,3
023300,2730,3451,3302,9483,023300,0.28788358114520723,0.363914373088685,0.34820204576610775,5
023301,525,741,439,1705,023301,0.30791788856304986,0.43460410557184753,0.25747800586510267,1
023302,412,643,312,1367,023302,0.3013899049012436,0.4703730797366496,0.2282370153621068,1
023400,1960,2111,2254,6325,023400,0.3098814229249012,0.33375494071146244,0.3563636363636364,3
023401,1179,1339,1827,4345,023401,0.2713463751438435,0.3081703107019563,0.4204833141542002,5
023402,720,817,1150,2687,023402,0.2679568291775214,0.3040565686639375,0.4279866021585411,5
023404,632,840,1094,2566,023404,0.24629773967264224,0.3273577552611068,0.426344505066251,5
023405,509,741,454,1704,023405,0.29870892018779344,0.43485915492957744,0.2664319248826291,4
023500,1246,2034,1671,4951,023500,0.25166633003433647,0.4108260957382347,0.3375075742274288,5
023501,1483,1932,1741,5156,023501,0.28762606671838636,0.37470907680372384,0.33766485647788985,5
023502,1283,1743,1639,4665,023502,0.27502679528403,0.37363344051446945,0.35133976420150054,5
023600,2271,2769,2270,7310,023600,0.3106703146374829,0.37879616963064294,0.31053351573187415,3
023700,1120,1413,1148,3681,023700,0.30426514534093996,0.38386308068459657,0.3118717739744635,3
023702,532,793,728,2053,023702,0.25913297613248903,0.3862640038967365,0.3546030199707745,5
023703,558,909,478,1945,023703,0.28688946015424166,0.4673521850899743,0.24575835475578406,4
023704,514,627,326,1467,023704,0.3503749147920927,0.4274028629856851,0.2222222222222222,1
023800,1656,1932,1541,5129,023800,0.32286995515695066,0.37668161434977576,0.3004484304932735,3
023801,558,693,2175,3426,023801,0.1628721541155867,0.202276707530648,0.6348511383537653,6
023802,124,167,639,930,023802,0.13333333333333333,0.17956989247311828,0.6870967741935484,6
023900,1605,2135,1614,5354,023900,0.2997758685095256,0.3987672768023907,0.3014568546880837,5
023901,787,1000,1156,2943,023901,0.2674142031940197,0.3397893306150187,0.3927964661909616,5
023902,982,1147,1403,3532,023902,0.27802944507361266,0.32474518686296716,0.3972253680634202,5
024000,1730,2297,2082,6109,024000,0.28318873792764776,0.37600261908659355,0.3408086429857587,5
024001,613,940,1074,2627,024001,0.23334602207841645,0.3578226113437381,0.40883136657784547,5
024002,212,370,255,837,024002,0.2532855436081243,0.44205495818399043,0.3046594982078853,5
024100,1895,2545,2246,6686,024100,0.28342805862997306,0.38064612623392163,0.3359258151361053,5
024101,619,835,872,2326,024101,0.266122098022356,0.3589853826311264,0.3748925193465176,5
024102,596,828,806,2230,024102,0.2672645739910314,0.37130044843049326,0.3614349775784753,5
024200,1179,1549,1319,4047,024200,0.29132690882134915,0.38275265628860883,0.325920434890042,5
024201,778,1030,1020,2828,024201,0.2751060820367751,0.3642149929278642,0.3606789250353607,5
024202,315,380,423,1118,024202,0.2817531305903399,0.33989266547406083,0.37835420393559926,5
024300,1411,2011,1822,5244,024300,0.26906941266209,0.38348588863463007,0.34744469870327993,5
024301,985,1141,1279,3405,024301,0.28928046989721,0.3350954478707783,0.37562408223201177,5
024302,1497,2195,1789,5481,024302,0.2731253420908593,0.40047436599160735,0.3264002919175333,5
024303,970,1162,1561,3693,024303,0.26265908475494176,0.3146493365827241,0.42269157866233414,5
024400,821,1121,1146,3088,024400,0.2658678756476684,0.3630181347150259,0.3711139896373057,5
024401,881,889,1842,3612,024401,0.24390919158361019,0.24612403100775193,0.5099667774086378,6
024402,418,462,1018,1898,024402,0.220231822971549,0.2434141201264489,0.5363540569020021,6
024404,568,559,1008,2135,024404,0.26604215456674474,0.26182669789227164,0.4721311475409836,6
024405,688,702,1073,2463,024405,0.2793341453511977,0.2850182704019488,0.4356475842468534,6
024406,303,366,402,1071,024406,0.28291316526610644,0.34173669467787116,0.3753501400560224,5
024500,2782,4063,4129,10974,024500,0.25350829232731914,0.37023874612720975,0.3762529615454711,5
024501,874,1044,928,2846,024501,0.3070976809557273,0.3668306394940267,0.32607167955024596,3
024502,830,1084,1037,2951,024502,0.28126058963063366,0.36733310742121317,0.35140630294815317,5
024600,1112,1258,1668,4038,024600,0.2753838533927687,0.31154036651807826,0.413075780089153,5
024700,1725,2412,2627,6764,024700,0.2550266114725015,0.3565937315198108,0.3883796570076878,5
024800,936,1130,2003,4069,024800,0.23003194888178913,0.277709510936348,0.4922585401818629,6
024900,946,1309,1720,3975,024900,0.2379874213836478,0.32930817610062896,0.4327044025157233,5
025000,390,547,691,1628,025000,0.23955773955773957,0.335995085995086,0.42444717444717445,5
025001,283,409,468,1160,025001,0.2439655172413793,0.35258620689655173,0.40344827586206894,5
025002,423,437,711,1571,025002,0.2692552514322088,0.2781667727562062,0.452577975811585,6
025003,151,151,294,596,025003,0.2533557046979866,0.2533557046979866,0.49328859060402686,6
025100,2625,3521,4170,10316,025100,0.2544590926715781,0.34131446297014345,0.4042264443582784,5
025200,1137,1515,1650,4302,025200,0.26429567642956764,0.3521617852161785,0.38354253835425384,5
025300,2887,3848,3908,10643,025300,0.2712581039180682,0.3615521939302828,0.367189702151649,5
025301,339,505,697,1541,025301,0.2199870214146658,0.32770927968851393,0.45230369889682026,5
025302,228,315,467,1010,025302,0.22574257425742575,0.3118811881188119,0.4623762376237624,5
025400,1631,2370,2719,6720,025400,0.24270833333333333,0.35267857142857145,0.40461309523809524,5
025500,2441,3351,3164,8956,025500,0.2725547119249665,0.37416257257704333,0.3532827154979902,5
025600,973,1349,1323,3645,025600,0.26694101508916324,0.3700960219478738,0.362962962962963,5
025700,1247,1698,2242,5187,025700,0.2404087140929246,0.32735685367264317,0.43223443223443225,5
025800,860,1102,1006,2968,025800,0.28975741239892183,0.37129380053908356,0.3389487870619946,5
025900,750,1065,1314,3129,025900,0.23969319271332695,0.34036433365292423,0.4199424736337488,5
025901,228,364,261,853,025901,0.2672919109026964,0.42672919109026963,0.305978898007034,5
025902,346,478,240,1064,025902,0.325187969924812,0.4492481203007519,0.22556390977443608,1
026000,668,719,726,2113,026000,0.3161381921438713,0.3402744912446758,0.3435873166114529,3
026100,2645,4006,3338,9989,026100,0.26479127039743716,0.4010411452597858,0.33416758434277705,5
026200,1011,1283,1564,3858,026200,0.2620528771384137,0.3325557283566615,0.40539139450492484,5
026300,2500,3770,2770,9040,026300,0.27654867256637167,0.4170353982300885,0.3064159292035398,5
026400,1578,2241,2243,6062,026400,0.2603101286704058,0.3696799736060706,0.3700098977235236,5
026500,2390,3225,3081,8696,026500,0.2748390064397424,0.37086016559337626,0.35430082796688134,5
026600,621,719,796,2136,026600,0.2907303370786517,0.3366104868913858,0.37265917602996257,5
026601,272,409,813,1494,026601,0.18206157965194109,0.2737617135207497,0.5441767068273092,6
026602,564,785,1386,2735,026602,0.20621572212065814,0.2870201096892139,0.5067641681901279,6
026700,1499,2277,2301,6077,026700,0.2466677636991937,0.3746914596017772,0.3786407766990291,5
026701,482,579,711,1772,026701,0.27200902934537247,0.32674943566591425,0.40124153498871334,5
026702,790,1152,1056,2998,026702,0.2635090060040027,0.3842561707805203,0.352234823215477,5
026800,485,620,545,1650,026800,0.29393939393939394,0.37575757575757573,0.3303030303030303,5
026900,1494,2335,1750,5579,026900,0.2677899265101273,0.41853378741709985,0.3136762860727729,5
026901,363,591,401,1355,026901,0.26789667896678965,0.4361623616236162,0.2959409594095941,4
026902,387,510,501,1398,026902,0.27682403433476394,0.3648068669527897,0.3583690987124464,5
027000,452,587,574,1613,027000,0.28022318660880347,0.36391816491010537,0.3558586484810911,5
027100,1839,2513,2457,6809,027100,0.2700837127331473,0.36907034806873257,0.36084593919812014,5
027200,577,750,714,2041,027200,0.2827045565899069,0.3674669279764821,0.349828515433611,5
027300,2146,3243,4103,9492,027300,0.2260851243152128,0.3416561314791403,0.43225874420564686,5
027301,415,471,1085,1971,027301,0.21055301877219684,0.2389649923896499,0.5504819888381532,6
027302,324,405,835,1564,027302,0.2071611253196931,0.25895140664961636,0.5338874680306905,6
027400,517,677,662,1856,027400,0.2785560344827586,0.36476293103448276,0.3566810344827586,5
027401,449,611,1215,2275,027401,0.19736263736263737,0.26857142857142857,0.5340659340659341,6
027402,272,343,795,1410,027402,0.19290780141843972,0.24326241134751772,0.5638297872340425,6
027500,1174,1577,2249,5000,027500,0.2348,0.3154,0.4498,5
027600,566,796,764,2126,027600,0.2662276575729069,0.374412041392286,0.35936030103480715,5
027700,2041,3010,2738,7789,027700,0.2620362049043523,0.3864424187957376,0.35152137629991015,5
027702,601,658,1498,2757,027702,0.2179905694595575,0.2386652158142909,0.5433442147261516,6
027704,341,438,844,1623,027704,0.21010474430067777,0.2698706099815157,0.5200246457178065,6
027705,461,611,959,2031,027705,0.22698178237321517,0.30083702609551943,0.47218119153126537,5
027706,306,356,630,1292,027706,0.23684210526315788,0.2755417956656347,0.48761609907120745,6
027800,549,744,740,2033,027800,0.27004426955238564,0.3659616330545991,0.36399409739301525,5
027900,2530,3831,4631,10992,027900,0.23016739446870452,0.34852620087336245,0.42130640465793306,5
028000,297,474,520,1291,028000,0.2300542215336948,0.36715724244771497,0.4027885360185902,5
028100,1594,2166,3116,6876,028100,0.23182082606166377,0.3150087260034904,0.45317044793484584,5
028200,438,660,703,1801,028200,0.24319822320932816,0.36646307606885065,0.3903387007218212,5
028300,2009,2911,3238,8158,028300,0.24626133856337337,0.3568276538367247,0.39691100759990194,5
028400,718,1033,1036,2787,028400,0.25762468604233946,0.37064944384642984,0.3717258701112307,5
028500,1353,2032,2517,5902,028500,0.22924432395798033,0.34429007116231786,0.4264656048797018,5
028501,83,100,85,268,028501,0.30970149253731344,0.373134328358209,0.31716417910447764,3
028502,317,484,280,1081,028502,0.29324699352451433,0.4477335800185014,0.2590194264569843,4
028600,641,789,1049,2479,028600,0.25857200484066156,0.318273497377975,0.42315449778136344,5
028700,1709,2206,2957,6872,028700,0.24869033760186263,0.3210128055878929,0.4302968568102445,5
028800,986,1343,1646,3975,028800,0.24805031446540882,0.3378616352201258,0.4140880503144654,5
028900,1273,1761,2161,5195,028900,0.24504331087584216,0.33897978825794034,0.4159769008662175,5
029000,458,622,659,1739,029000,0.26336975273145485,0.35767682576193216,0.378953421506613,5
029100,1854,2953,2457,7264,029100,0.25523127753303965,0.40652533039647576,0.3382433920704846,5
029102,275,359,673,1307,029102,0.21040550879877581,0.2746748278500383,0.5149196633511859,6
029103,661,787,1486,2934,029103,0.2252897068847989,0.26823449216087253,0.5064758009543285,6
029104,569,730,1407,2706,029104,0.21027346637102734,0.2697708795269771,0.5199556541019955,6
029200,203,288,316,807,029200,0.25154894671623296,0.35687732342007433,0.3915737298636927,5
029300,1315,1874,1563,4752,029300,0.2767255892255892,0.39436026936026936,0.32891414141414144,5
029301,161,162,483,806,029301,0.19975186104218362,0.20099255583126552,0.5992555831265509,6
029302,341,425,1198,1964,029302,0.17362525458248473,0.21639511201629327,0.609979633401222,6
029400,673,1005,1101,2779,029400,0.2421734436847787,0.361640878013674,0.39618567830154733,5
029500,1825,2320,4308,8453,029500,0.21589968058677392,0.27445877203359753,0.5096415473796285,6
029600,792,1337,1434,3563,029600,0.22228459163626157,0.37524557956778,0.40246982879595844,5
029700,974,1182,2096,4252,029700,0.229068673565381,0.2779868297271872,0.4929444967074318,6
029800,400,563,512,1475,029800,0.2711864406779661,0.38169491525423727,0.34711864406779663,5
029900,688,965,731,2384,029900,0.28859060402684567,0.4047818791946309,0.3066275167785235,5
030000,1520,1851,3063,6434,030000,0.23624494870997825,0.2876903947777432,0.47606465651227853,6
030100,1345,1780,1852,4977,030100,0.2702431183443842,0.35764516777175004,0.37211171388386577,5
030200,1711,2484,3045,7240,030200,0.23632596685082874,0.3430939226519337,0.4205801104972376,5
030201,543,603,775,1921,030201,0.2826652785007808,0.31389901093180633,0.4034357105674128,5
030202,637,803,1133,2573,030202,0.24757092887679752,0.31208705790905555,0.4403420132141469,5
030300,1543,2089,2121,5753,030300,0.26820789153485136,0.3631148965756996,0.36867721188944896,5
030301,589,750,1191,2530,030301,0.23280632411067192,0.2964426877470356,0.4707509881422925,6
030302,732,880,1317,2929,030302,0.2499146466370775,0.300443837487197,0.4496415158757255,5
030400,1268,1588,1637,4493,030400,0.28221678166036057,0.3534386823948364,0.36434453594480304,5
030500,1050,1368,1934,4352,030500,0.24126838235294118,0.31433823529411764,0.4443933823529412,5
030501,274,273,426,973,030501,0.2816032887975334,0.2805755395683453,0.43782117163412126,6
030502,349,395,791,1535,030502,0.2273615635179153,0.25732899022801303,0.5153094462540717,6
030600,1496,2136,2139,5771,030600,0.25922717033443077,0.3701264945416739,0.37064633512389533,5
030700,3005,3837,4591,11433,030700,0.2628356511851658,0.33560745211230647,0.40155689670252775,5
030701,387,477,1377,2241,030701,0.17269076305220885,0.21285140562248997,0.6144578313253012,6
030800,1764,2450,2291,6505,030800,0.2711760184473482,0.3766333589546503,0.35219062259800155,5
030900,1745,2326,2686,6757,030900,0.25825070297469294,0.34423560751812937,0.39751368950717775,5
030902,604,936,1040,2580,030902,0.23410852713178296,0.3627906976744186,0.40310077519379844,5
030903,505,791,823,2119,030903,0.2383199622463426,0.37328928739971684,0.38839075035394055,5
030904,306,381,506,1193,030904,0.2564962279966471,0.3193629505448449,0.42414082145850796,5
031000,923,1142,1530,3595,031000,0.25674547983310153,0.317663421418637,0.42559109874826145,5
031100,1080,1576,1626,4282,031100,0.25221858944418496,0.36805231200373656,0.3797290985520785,5
031200,589,736,892,2217,031200,0.2656743346865133,0.33198015336039693,0.40234551195308976,5
031300,894,1356,1505,3755,031300,0.23808255659121172,0.3611185086551265,0.4007989347536618,5
031400,1188,1514,1747,4449,031400,0.2670262980445044,0.3403011912789391,0.3926725106765565,5
031500,528,834,927,2289,031500,0.2306684141546527,0.36435124508519,0.40498034076015726,5
031600,207,242,391,840,031600,0.24642857142857144,0.28809523809523807,0.4654761904761905,6
031700,351,573,1110,2034,031700,0.17256637168141592,0.28171091445427726,0.5457227138643068,6
031701,402,585,686,1673,031701,0.2402869097429767,0.3496712492528392,0.4100418410041841,5
031702,374,526,691,1591,031702,0.2350722815839095,0.33060967944688874,0.43431803896920174,5
031703,516,475,3550,4541,031703,0.11363135873155693,0.10460251046025104,0.781766130808192,6
031704,366,426,2745,3537,031704,0.10347752332485156,0.12044105173876166,0.7760814249363868,6
031800,187,233,358,778,031800,0.2403598971722365,0.2994858611825193,0.4601542416452442,6
031900,1189,1344,2411,4944,031900,0.2404935275080906,0.27184466019417475,0.48766181229773464,6
031901,384,500,450,1334,031901,0.28785607196401797,0.3748125937031484,0.3373313343328336,5
031902,552,730,738,2020,031902,0.2732673267326733,0.3613861386138614,0.36534653465346534,5
032000,890,1128,2225,4243,032000,0.20975724723073297,0.2658496346924346,0.5243931180768324,6
032100,538,837,792,2167,032100,0.24826949700046147,0.3862482694970005,0.36548223350253806,5
032101,458,359,1510,2327,032101,0.19681993983669963,0.1542758917060593,0.6489041684572411,6
032102,193,122,472,787,032102,0.24523506988564167,0.15501905972045743,0.5997458703939009,6
032200,469,659,890,2018,032200,0.232408325074331,0.3265609514370664,0.44103072348860256,5
032300,1177,1698,2618,5493,032300,0.21427271072273804,0.3091206990715456,0.4766065902057164,5
032400,294,414,411,1119,032400,0.26273458445040215,0.3699731903485255,0.3672922252010724,5
032402,266,289,687,1242,032402,0.214170692431562,0.23268921095008052,0.5531400966183575,6
032403,234,335,526,1095,032403,0.2136986301369863,0.3059360730593607,0.480365296803653,5
032404,620,713,1433,2766,032404,0.22415039768618944,0.25777295733911787,0.5180766449746927,6
032500,675,1008,918,2601,032500,0.25951557093425603,0.3875432525951557,0.35294117647058826,5
032502,333,386,811,1530,032502,0.21764705882352942,0.2522875816993464,0.5300653594771242,6
032503,407,410,884,1701,032503,0.23927101704879483,0.24103468547912993,0.5196942974720753,6
032504,204,237,601,1042,032504,0.19577735124760076,0.22744721689059502,0.5767754318618042,6
032600,877,1195,1196,3268,032600,0.26835985312117505,0.3656670746634027,0.3659730722154223,5
032601,220,265,475,960,032601,0.22916666666666666,0.2760416666666667,0.4947916666666667,6
032602,374,538,737,1649,032602,0.2268041237113402,0.32625833838690116,0.44693753790175866,5
032700,1067,1563,1629,4259,032700,0.25052829302653207,0.3669875557642639,0.38248415120920404,5
032800,912,1289,1363,3564,032800,0.2558922558922559,0.361672278338945,0.3824354657687991,5
032900,903,1347,1258,3508,032900,0.2574116305587229,0.3839794754846066,0.35860889395667045,5
032901,412,566,774,1752,032901,0.23515981735159816,0.3230593607305936,0.4417808219178082,5
032902,399,597,929,1925,032902,0.20727272727272728,0.31012987012987014,0.4825974025974026,5
033000,1384,2244,2136,5764,033000,0.24011103400416378,0.3893129770992366,0.3705759888965996,5
033002,231,269,539,1039,033002,0.22232916265640038,0.25890279114533205,0.5187680461982676,6
033003,361,458,743,1562,033003,0.23111395646606914,0.293213828425096,0.47567221510883484,6
033004,295,465,590,1350,033004,0.21851851851851853,0.34444444444444444,0.43703703703703706,5
033100,662,850,603,2115,033100,0.31300236406619386,0.40189125295508277,0.2851063829787234,1
033101,200,270,499,969,033101,0.20639834881320948,0.2786377708978328,0.5149638802889577,6
033102,552,643,1215,2410,033102,0.22904564315352696,0.26680497925311203,0.504149377593361,6
033200,370,599,486,1455,033200,0.2542955326460481,0.41168384879725084,0.334020618556701,5
033201,315,526,641,1482,033201,0.2125506072874494,0.3549257759784076,0.432523616734143,5
033202,318,495,621,1434,033202,0.2217573221757322,0.34518828451882844,0.4330543933054393,5
033300,843,1011,1105,2959,033300,0.2848935451165934,0.3416694829334235,0.3734369719499831,5
033400,325,467,439,1231,033400,0.26401299756295693,0.3793663688058489,0.3566206336311942,5
033401,228,426,411,1065,033401,0.2140845070422535,0.4,0.38591549295774646,5
033402,839,1560,1655,4054,033402,0.2069560927479033,0.3848051307350765,0.40823877651702023,5
033500,642,936,1175,2753,033500,0.2332001452960407,0.33999273519796586,0.4268071195059935,5
033600,900,1368,1532,3800,033600,0.23684210526315788,0.36,0.4031578947368421,5
033700,809,1144,1476,3429,033700,0.23592884222805482,0.3336249635462234,0.4304461942257218,5
033800,409,578,528,1515,033800,0.26996699669966995,0.3815181518151815,0.3485148514851485,5
033900,662,972,1126,2760,033900,0.2398550724637681,0.3521739130434783,0.40797101449275364,5
034000,632,930,861,2423,034000,0.26083367725959555,0.38382170862567067,0.3553446141147338,5
034100,262,378,495,1135,034100,0.23083700440528634,0.33303964757709253,0.43612334801762115,5
034200,741,1062,875,2678,034200,0.2766990291262136,0.3965646004480956,0.3267363704256908,5
034300,648,945,883,2476,034300,0.2617124394184168,0.3816639741518578,0.35662358642972536,5
034400,148,202,299,649,034400,0.2280431432973806,0.31124807395993837,0.46070878274268107,5
034500,505,738,1093,2336,034500,0.21618150684931506,0.3159246575342466,0.4678938356164384,5
034700,571,848,715,2134,034700,0.267572633552015,0.39737582005623245,0.33505154639175255,5
034800,647,1111,1026,2784,034800,0.23239942528735633,0.399066091954023,0.36853448275862066,5
034900,512,869,575,1956,034900,0.261758691206544,0.4442740286298569,0.2939672801635992,4
035000,516,779,776,2071,035000,0.2491549975857074,0.3761467889908257,0.37469821342346693,5
035100,1410,1948,2233,5591,035100,0.2521910212842068,0.34841709890896083,0.3993918798068324,5
035200,256,433,478,1167,035200,0.21936589545844046,0.37103684661525277,0.40959725792630675,5
035300,1002,1484,1287,3773,035300,0.2655711635303472,0.39332096474953615,0.34110787172011664,5
035400,839,1096,1197,3132,035400,0.2678799489144317,0.3499361430395913,0.382183908045977,5
035500,853,1271,970,3094,035500,0.2756948933419522,0.4107950872656755,0.31351001939237233,5
035600,571,811,616,1998,035600,0.2857857857857858,0.4059059059059059,0.3083083083083083,5
035601,246,406,460,1112,035601,0.22122302158273383,0.36510791366906475,0.4136690647482014,5
035602,379,570,829,1778,035602,0.21316085489313835,0.3205849268841395,0.46625421822272217,5
035700,918,1331,1160,3409,035700,0.2692871809914931,0.39043707832208857,0.3402757406864183,5
035800,1317,1922,2149,5388,035800,0.24443207126948774,0.3567186340014848,0.39884929472902747,5
035900,673,1106,726,2505,035900,0.2686626746506986,0.4415169660678643,0.2898203592814371,4
035901,548,527,658,1733,035901,0.31621465666474324,0.3040969417195615,0.37968840161569534,3
035902,99,99,103,301,035902,0.3289036544850498,0.3289036544850498,0.34219269102990035,3
036000,697,961,1027,2685,036000,0.2595903165735568,0.3579143389199255,0.3824953445065177,5
036001,290,377,403,1070,036001,0.27102803738317754,0.35233644859813085,0.3766355140186916,5
036002,363,529,416,1308,036002,0.2775229357798165,0.404434250764526,0.3180428134556575,5
036100,1611,2265,1652,5528,036100,0.29142547033285093,0.40973227206946455,0.2988422575976845,4
036200,306,478,384,1168,036200,0.261986301369863,0.4092465753424658,0.3287671232876712,5
036300,1698,2218,1634,5550,036300,0.30594594594594593,0.39963963963963967,0.2944144144144144,1
036400,494,751,638,1883,036400,0.2623473181093999,0.3988316516197557,0.33882103027084437,5
036401,343,366,352,1061,036401,0.3232799245994345,0.3449575871819039,0.33176248821866167,3
036402,384,472,411,1267,036402,0.303078137332281,0.372533543804262,0.324388318863457,3
036500,838,1089,887,2814,036500,0.2977967306325515,0.38699360341151384,0.31520966595593464,5
036501,646,1072,856,2574,036501,0.25097125097125095,0.41647241647241645,0.33255633255633255,5
036502,361,563,362,1286,036502,0.2807153965785381,0.43779160186625193,0.28149300155520995,4
036600,963,1224,1174,3361,036600,0.2865218684915204,0.36417732817613807,0.3493008033323416,5
036700,1117,1500,1095,3712,036700,0.30091594827586204,0.4040948275862069,0.29498922413793105,1
036800,837,1218,1223,3278,036800,0.2553386211104332,0.37156802928615007,0.3730933496034167,5
036900,512,722,496,1730,036900,0.29595375722543354,0.41734104046242776,0.28670520231213875,4
036901,623,736,739,2098,036901,0.2969494756911344,0.3508102955195424,0.35224022878932315,5
036902,859,1184,999,3042,036902,0.28238001314924394,0.3892176199868508,0.32840236686390534,5
037000,1079,1443,1707,4229,037000,0.2551430598250177,0.341215417356349,0.40364152281863325,5
037100,1489,2145,1872,5506,037100,0.2704322557210316,0.38957500908100257,0.33999273519796586,5
037200,798,939,918,2655,037200,0.30056497175141245,0.3536723163841808,0.34576271186440677,3
037300,1911,2661,2007,6579,037300,0.29046967624259007,0.404468764249886,0.30506155950752395,5
037400,927,1255,1062,3244,037400,0.2857583230579531,0.3868680641183724,0.3273736128236745,5
037401,419,531,721,1671,037401,0.25074805505685216,0.3177737881508079,0.4314781567923399,5
037402,417,596,755,1768,037402,0.23585972850678733,0.33710407239819007,0.4270361990950226,5
037500,1291,1726,1586,4603,037500,0.28046925917879645,0.3749728437975234,0.3445578970236802,5
037504,329,531,258,1118,037504,0.29427549194991054,0.4749552772808587,0.23076923076923078,4
037600,971,1482,1428,3881,037600,0.25019324916258695,0.38186034527183715,0.3679464055655759,5
037700,550,955,871,2376,037700,0.23148148148148148,0.4019360269360269,0.36658249158249157,5
037800,345,514,395,1254,037800,0.2751196172248804,0.4098883572567783,0.3149920255183413,5
037900,1233,1878,1244,4355,037900,0.28312284730195175,0.4312284730195178,0.2856486796785304,4
038000,460,665,615,1740,038000,0.26436781609195403,0.382183908045977,0.35344827586206895,5
038100,1474,2309,1625,5408,038100,0.27255917159763315,0.42696005917159763,0.3004807692307692,5
038200,996,1279,1005,3280,038200,0.30365853658536585,0.3899390243902439,0.30640243902439024,3
038300,321,522,587,1430,038300,0.22447552447552446,0.365034965034965,0.4104895104895105,5
038301,543,842,405,1790,038301,0.30335195530726256,0.47039106145251397,0.22625698324022347,1
038302,658,886,500,2044,038302,0.3219178082191781,0.4334637964774951,0.2446183953033268,1
038400,188,358,333,879,038400,0.21387940841865757,0.4072810011376564,0.378839590443686,5
038500,675,968,753,2396,038500,0.2817195325542571,0.4040066777963272,0.3142737896494157,5
038600,1201,1844,1554,4599,038600,0.26114372689715154,0.400956729723853,0.3378995433789954,5
038700,662,1012,743,2417,038700,0.27389325610260656,0.4187008688456765,0.307405875051717,5
038800,485,691,945,2121,038800,0.22866572371522867,0.3257897218293258,0.44554455445544555,5
038900,740,1126,784,2650,038900,0.2792452830188679,0.4249056603773585,0.2958490566037736,4
039000,425,648,729,1802,039000,0.2358490566037736,0.35960044395116536,0.40455049944506105,5
039100,835,1339,952,3126,039100,0.26711452335252717,0.42834293026231607,0.30454254638515676,5
039200,417,575,643,1635,039200,0.25504587155963304,0.3516819571865443,0.39327217125382263,5
039300,1089,1589,1030,3708,039300,0.2936893203883495,0.4285329018338727,0.2777777777777778,4
039400,854,1353,1302,3509,039400,0.24337418067825592,0.38557993730407525,0.37104588201766886,5
039500,680,1033,809,2522,039500,0.2696272799365583,0.40959555908009515,0.3207771609833466,5
039600,543,815,800,2158,039600,0.2516218721037998,0.37766450417052827,0.3707136237256719,5
039700,692,1032,728,2452,039700,0.2822185970636215,0.42088091353996737,0.2969004893964111,4
039800,722,1049,1057,2828,039800,0.2553041018387553,0.37093352192362095,0.37376237623762376,5
039900,721,982,806,2509,039900,0.28736548425667596,0.39139099242726183,0.32124352331606215,5
039901,601,868,477,1946,039901,0.30883864337101746,0.4460431654676259,0.24511819116135664,1
039902,595,815,484,1894,039902,0.31414994720168954,0.4303062302006336,0.2555438225976769,1
040000,464,600,542,1606,040000,0.2889165628891656,0.37359900373599003,0.33748443337484435,5
040001,609,696,1090,2395,040001,0.25427974947807935,0.2906054279749478,0.4551148225469729,6
040003,479,552,811,1842,040003,0.26004343105320304,0.2996742671009772,0.44028230184581973,6
040100,2161,3300,2429,7890,040100,0.2738910012674271,0.41825095057034223,0.30785804816223067,5
040200,1764,2399,2523,6686,040200,0.26383487885133117,0.35880945258749625,0.3773556685611726,5
040300,1669,2761,2124,6554,040300,0.25465364662801343,0.42126945376869085,0.3240768996032957,5
040302,364,640,384,1388,040302,0.2622478386167147,0.4610951008645533,0.276657060518732,4
040303,344,619,686,1649,040303,0.20861127956337175,0.375379017586416,0.41600970285021227,5
040304,338,560,540,1438,040304,0.23504867872044508,0.3894297635605007,0.37552155771905427,5
040400,2038,3047,2634,7719,040400,0.26402383728462236,0.3947402513278922,0.34123591138748544,5
040500,1329,1793,1483,4605,040500,0.28859934853420194,0.38935939196525515,0.3220412595005429,5
040501,367,616,380,1363,040501,0.2692589875275128,0.45194424064563465,0.27879677182685253,4
040502,581,973,582,2136,040502,0.2720037453183521,0.45552434456928836,0.27247191011235955,4
040600,1892,2696,2685,7273,040600,0.2601402447408222,0.3706860992712773,0.3691736559879005,5
040700,2070,2936,2475,7481,040700,0.2767009758053736,0.392460900949071,0.3308381232455554,5
040701,283,447,455,1185,040701,0.23881856540084387,0.37721518987341773,0.38396624472573837,5
040702,650,966,723,2339,040702,0.2778965369816161,0.41299700726806327,0.30910645575032064,5
040800,1473,1964,1930,5367,040800,0.27445500279485746,0.3659400037264766,0.3596049934786659,5
040801,620,903,955,2478,040801,0.25020177562550444,0.3644067796610169,0.38539144471347864,5
040802,619,864,865,2348,040802,0.26362862010221466,0.3679727427597956,0.36839863713798976,5
040900,1757,2768,2410,6935,040900,0.253352559480894,0.3991348233597693,0.3475126171593367,5
041000,1103,1614,1538,4255,041000,0.2592244418331375,0.3793184488836663,0.36145710928319624,5
041100,2043,2731,2827,7601,041100,0.26878042362846993,0.35929482962768056,0.3719247467438495,5
041200,1170,1607,1843,4620,041200,0.2532467532467532,0.34783549783549783,0.3989177489177489,5
041300,2178,3160,2705,8043,041300,0.2707944796717643,0.3928882257863981,0.3363172945418376,5
041400,1630,2582,2610,6822,041400,0.23893286426267957,0.3784813837584286,0.38258575197889183,5
041401,81,147,227,455,041401,0.17802197802197803,0.3230769230769231,0.4989010989010989,5
041402,116,226,204,546,041402,0.21245421245421245,0.4139194139194139,0.37362637362637363,5
041500,1606,2432,2035,6073,041500,0.2644492013831714,0.4004610571381525,0.3350897414786761,5
041600,523,654,761,1938,041600,0.26986584107327144,0.33746130030959753,0.3926728586171311,5
041700,850,1212,1017,3079,041700,0.27606365703150376,0.3936342968496265,0.33030204611886976,5
041800,1080,1428,1379,3887,041800,0.2778492410599434,0.36737844095703626,0.35477231798302034,5
041900,954,1567,1222,3743,041900,0.2548757681004542,0.4186481432006412,0.3264760886989046,5
042000,565,863,763,2191,042000,0.2578731172980374,0.3938840712003651,0.34824281150159747,5
042100,1301,1906,1626,4833,042100,0.26919097868818537,0.39437202565694185,0.33643699565487273,5
042200,599,929,846,2374,042200,0.2523167649536647,0.3913226621735468,0.35636057287278855,5
042300,808,1217,1004,3029,042300,0.26675470452294486,0.4017827665896335,0.3314625288874216,5
042400,798,1157,1160,3115,042400,0.25617977528089886,0.37142857142857144,0.3723916532905297,5
042500,1040,1378,1035,3453,042500,0.3011873732985809,0.39907326962061973,0.2997393570807993,1
042600,1091,1594,1536,4221,042600,0.2584695569770197,0.37763563136697464,0.3638948116560057,5
042700,868,1284,1079,3231,042700,0.2686474775611266,0.39740018570102137,0.3339523367378521,5
042800,560,925,906,2391,042800,0.23421162693433709,0.38686741948975323,0.37892095357590966,5
042900,446,776,581,1803,042900,0.2473655019412091,0.43039378813089296,0.32224070992789794,5
042901,301,468,342,1111,042901,0.2709270927092709,0.42124212421242124,0.30783078307830786,5
042902,386,574,448,1408,042902,0.2741477272727273,0.40767045454545453,0.3181818181818182,5
043000,612,890,937,2439,043000,0.25092250922509224,0.36490364903649036,0.3841738417384174,5
043100,1348,2088,1524,4960,043100,0.2717741935483871,0.42096774193548386,0.307258064516129,5
043200,562,677,682,1921,043200,0.2925559604372723,0.3524206142634045,0.3550234252993233,5
043300,403,634,388,1425,043300,0.2828070175438597,0.44491228070175437,0.27228070175438596,4
043400,807,1323,1260,3390,043400,0.23805309734513275,0.3902654867256637,0.37168141592920356,5
043500,496,847,547,1890,043500,0.2624338624338624,0.44814814814814813,0.2894179894179894,4
043600,638,867,873,2378,043600,0.2682926829268293,0.36459209419680405,0.3671152228763667,5
043700,550,859,540,1949,043700,0.2821959979476655,0.44073884043099026,0.27706516162134426,4
043701,218,366,311,895,043701,0.2435754189944134,0.40893854748603353,0.3474860335195531,5
043702,430,686,669,1785,043702,0.24089635854341737,0.3843137254901961,0.37478991596638656,5
043800,222,327,334,883,043800,0.25141562853907135,0.37032842582106457,0.3782559456398641,5
043900,639,1052,796,2487,043900,0.2569360675512666,0.42299959790912744,0.320064334539606,5
044000,507,764,798,2069,044000,0.24504591590140165,0.36926051232479457,0.38569357177380376,5
044100,554,808,617,1979,044100,0.27993936331480546,0.40828701364325415,0.3117736230419404,5
044200,498,870,785,2153,044200,0.23130515559684162,0.4040873200185787,0.36460752438457966,5
044300,478,738,685,1901,044300,0.25144660704892163,0.3882167280378748,0.3603366649132036,5
044301,313,388,373,1074,044301,0.2914338919925512,0.3612662942271881,0.3472998137802607,5
044302,481,599,472,1552,044302,0.30992268041237114,0.3859536082474227,0.30412371134020616,3
044400,834,1363,1329,3526,044400,0.23652864435621102,0.3865570051049348,0.37691435053885425,5
044500,474,680,789,1943,044500,0.24395265054040144,0.34997426659804426,0.4060730828615543,5
044600,199,196,364,759,044600,0.2621870882740448,0.25823451910408435,0.4795783926218709,6
044601,249,397,345,991,044601,0.2512613521695257,0.40060544904137235,0.3481331987891019,5
044602,324,577,435,1336,044602,0.24251497005988024,0.4318862275449102,0.3255988023952096,5
044700,292,396,365,1053,044700,0.27730294396961064,0.37606837606837606,0.3466286799620133,5
044800,600,917,989,2506,044800,0.23942537909018355,0.3659217877094972,0.39465283320031924,5
044900,446,637,571,1654,044900,0.26964933494558646,0.3851269649334946,0.34522370012091896,5
044901,211,320,384,915,044901,0.23060109289617486,0.34972677595628415,0.419672131147541,5
044902,250,295,462,1007,044902,0.24826216484607747,0.2929493545183714,0.45878848063555117,6
045000,258,348,411,1017,045000,0.2536873156342183,0.3421828908554572,0.40412979351032446,5
045101,208,255,409,872,045101,0.23853211009174313,0.29243119266055045,0.4690366972477064,6
045102,230,317,471,1018,045102,0.22593320235756384,0.3113948919449902,0.462671905697446,5
045200,263,374,499,1136,045200,0.23151408450704225,0.32922535211267606,0.4392605633802817,5
045300,253,340,363,956,045300,0.26464435146443516,0.35564853556485354,0.3797071129707113,5
045400,585,748,801,2134,045400,0.27413308341143394,0.35051546391752575,0.3753514526710403,5
045500,1157,1974,1986,5117,045500,0.22610904827047099,0.3857729138166895,0.38811803791283955,5
045600,649,904,1023,2576,045600,0.2519409937888199,0.35093167701863354,0.39712732919254656,5
045700,362,430,476,1268,045700,0.2854889589905363,0.3391167192429022,0.3753943217665615,5
045800,818,1180,1151,3149,045800,0.25976500476341696,0.37472213401079707,0.36551286122578597,5
045900,414,498,445,1357,045900,0.3050847457627119,0.36698599852616065,0.32792925571112747,3
046000,1054,1683,1455,4192,046000,0.2514312977099237,0.4014790076335878,0.34708969465648853,5
046100,283,360,278,921,046100,0.30727470141150925,0.39087947882736157,0.30184581976112923,3
046200,575,928,758,2261,046200,0.254312251216276,0.410437859354268,0.335249889429456,5
046201,2273,3431,5453,11157,046201,0.20372860087837233,0.30751994263690957,0.4887514564847181,5
046202,814,1190,1707,3711,046202,0.21934788466720562,0.32066828348154136,0.459983831851253,5
046300,378,521,377,1276,046300,0.2962382445141066,0.40830721003134796,0.29545454545454547,4
046400,362,383,515,1260,046400,0.2873015873015873,0.30396825396825394,0.4087301587301587,5
046500,285,434,251,970,046500,0.29381443298969073,0.44742268041237115,0.25876288659793817,4
046600,185,321,535,1041,046600,0.1777137367915466,0.30835734870317005,0.5139289145052833,5
046700,649,878,615,2142,046700,0.3029878618113912,0.4098972922502334,0.28711484593837533,1
046800,529,736,673,1938,046800,0.27296181630546956,0.3797729618163055,0.34726522187822495,5
046900,777,1113,841,2731,046900,0.2845111680703039,0.40754302453313807,0.307945807396558,5
047000,616,729,615,1960,047000,0.3142857142857143,0.3719387755102041,0.3137755102040816,3
047100,452,545,592,1589,047100,0.2844556324732536,0.34298300818124605,0.37256135934550033,5
047200,549,610,939,2098,047200,0.2616777883698761,0.29075309818875117,0.44756911344137273,6
047300,344,485,614,1443,047300,0.2383922383922384,0.3361053361053361,0.4255024255024255,5
047400,309,270,257,836,047400,0.3696172248803828,0.3229665071770335,0.30741626794258375,3
047500,422,536,651,1609,047500,0.2622747047855811,0.3331261653200746,0.4045991298943443,5
047600,548,511,572,1631,047600,0.3359901900674433,0.3133047210300429,0.3507050889025138,3
047700,430,505,1397,2332,047700,0.1843910806174957,0.21655231560891938,0.5990566037735849,6
047800,865,1004,1375,3244,047800,0.2666461159062885,0.3094944512946979,0.42385943279901356,5
047900,499,743,784,2026,047900,0.24629812438302073,0.3667324777887463,0.386969397828233,5
048000,593,796,669,2058,048000,0.2881438289601555,0.3867832847424684,0.3250728862973761,5
048100,885,1099,1402,3386,048100,0.261370348493798,0.3245717660956881,0.41405788541051386,5
048200,715,938,943,2596,048200,0.2754237288135593,0.3613251155624037,0.363251155624037,5
048300,385,504,490,1379,048300,0.27918781725888325,0.36548223350253806,0.3553299492385787,5
048400,1301,2069,1756,5126,048400,0.25380413577838473,0.4036285602809208,0.3425673039406945,5
048500,813,1043,1235,3091,048500,0.26302167583306374,0.33743125202199936,0.3995470721449369,5
048600,363,412,312,1087,048600,0.33394664213431463,0.37902483900643974,0.28702851885924563,1
048800,422,485,629,1536,048800,0.2747395833333333,0.3157552083333333,0.4095052083333333,5
048900,523,785,537,1845,048900,0.2834688346883469,0.4254742547425474,0.2910569105691057,4
049000,544,782,817,2143,049000,0.2538497433504433,0.36490900606626225,0.38124125058329444,5
049100,814,986,992,2792,049100,0.2915472779369627,0.3531518624641834,0.3553008595988539,5
049200,723,1035,1268,3026,049200,0.23892927957699933,0.34203569068076667,0.419035029742234,5
049300,759,1289,1147,3195,049300,0.2375586854460094,0.40344287949921753,0.3589984350547731,5
049301,209,215,368,792,049301,0.2638888888888889,0.27146464646464646,0.46464646464646464,6
049302,214,361,449,1024,049302,0.208984375,0.3525390625,0.4384765625,5
049400,453,631,922,2006,049400,0.22582253240279163,0.31455633100697905,0.4596211365902293,5
049500,479,668,1173,2320,049500,0.20646551724137932,0.28793103448275864,0.5056034482758621,6
049600,663,1043,1207,2913,049600,0.22760041194644695,0.35805012015104704,0.414349467902506,5
049700,564,835,1672,3071,049700,0.18365353305112342,0.2718984044285249,0.5444480625203517,6
049800,386,457,731,1574,049800,0.24523506988564167,0.2903430749682338,0.4644218551461245,6
049900,682,910,1329,2921,049900,0.23348168435467306,0.31153714481342004,0.45498117083190687,5
050000,741,1101,1455,3297,050000,0.22474977252047315,0.33393994540491356,0.44131028207461326,5
050100,351,412,930,1693,050100,0.2073242764323686,0.24335499113998818,0.5493207324276432,6
050101,419,359,839,1617,050101,0.259121830550402,0.2220160791589363,0.5188620902906618,6
050102,1595,1553,3027,6175,050102,0.2582995951417004,0.251497975708502,0.49020242914979756,6
050103,457,503,1019,1979,050103,0.23092470944921678,0.2541687721071248,0.5149065184436584,6
050104,505,520,1134,2159,050104,0.23390458545622975,0.24085224641037517,0.5252431681333951,6
050201,870,1180,1415,3465,050201,0.2510822510822511,0.34054834054834054,0.4083694083694084,5
050202,1054,1408,2130,4592,050202,0.22952961672473868,0.30662020905923343,0.46385017421602787,5
050203,427,434,862,1723,050203,0.2478235635519443,0.2518862449216483,0.5002901915264074,6
050204,242,222,496,960,050204,0.2520833333333333,0.23125,0.5166666666666667,6
050205,424,383,875,1682,050205,0.2520808561236623,0.22770511296076099,0.5202140309155767,6
050300,355,439,822,1616,050300,0.21967821782178218,0.2716584158415842,0.5086633663366337,6
050301,538,786,740,2064,050301,0.2606589147286822,0.3808139534883721,0.35852713178294576,5
050302,545,805,748,2098,050302,0.25977121067683506,0.38369876072449954,0.3565300285986654,5
050400,1512,1916,2902,6330,050400,0.23886255924170616,0.3026856240126382,0.4584518167456556,5
050500,1401,1787,2229,5417,050500,0.25863023813919145,0.3298873915451357,0.41148237031567286,5
050600,662,1030,872,2564,050600,0.2581903276131045,0.4017160686427457,0.34009360374414976,5
050601,679,658,1188,2525,050601,0.2689108910891089,0.2605940594059406,0.47049504950495047,6
050602,638,742,977,2357,050602,0.2706830717013152,0.3148069579974544,0.4145099703012304,5
050700,539,593,932,2064,050700,0.2611434108527132,0.2873062015503876,0.45155038759689925,6
050800,677,833,987,2497,050800,0.2711253504205046,0.33360032038446136,0.395274329195034,5
050801,480,735,503,1718,050801,0.27939464493597205,0.4278230500582072,0.2927823050058207,4
050803,280,432,411,1123,050803,0.2493321460373998,0.3846838824577026,0.3659839715048976,5
050804,620,942,876,2438,050804,0.25430680885972107,0.3863822805578343,0.35931091058244463,5
050900,898,777,830,2505,050900,0.3584830339321357,0.31017964071856285,0.3313373253493014,3
051000,605,765,835,2205,051000,0.2743764172335601,0.3469387755102041,0.3786848072562358,5
051001,475,777,550,1802,051001,0.26359600443951164,0.43118756936736957,0.3052164261931188,5
051002,482,777,674,1933,051002,0.24935333678220384,0.40196585618210035,0.3486808070356958,5
051100,1051,1459,1867,4377,051100,0.24011880283299064,0.3333333333333333,0.42654786383367604,5
051200,1525,2247,2191,5963,051200,0.2557437531443904,0.3768237464363575,0.3674325004192521,5
051300,1201,1587,2541,5329,051300,0.22537061362356914,0.2978044661287296,0.47682492024770123,6
051400,1125,1827,1658,4610,051400,0.2440347071583514,0.3963123644251627,0.3596529284164859,5
051500,1137,1530,2179,4846,051500,0.2346264960792406,0.31572430870821294,0.4496491952125464,5
051600,1615,2292,3123,7030,051600,0.22972972972972974,0.3260312944523471,0.4442389758179232,5
051601,632,957,649,2238,051601,0.28239499553172476,0.42761394101876676,0.2899910634495085,4
051602,474,688,459,1621,051602,0.2924120913016656,0.4244293645897594,0.28315854410857494,4
051700,646,840,1427,2913,051700,0.22176450394782013,0.2883625128733265,0.4898729831788534,6
051701,290,386,453,1129,051701,0.25686448184233834,0.34189548272807796,0.4012400354295837,5
051702,342,518,575,1435,051702,0.23832752613240418,0.36097560975609755,0.40069686411149824,5
051800,1725,2363,2920,7008,051800,0.2461472602739726,0.3371860730593607,0.4166666666666667,5
051900,847,1026,2270,4143,051900,0.20444122616461502,0.24764663287472846,0.5479121409606565,6
051901,645,739,1340,2724,051901,0.236784140969163,0.2712922173274596,0.4919236417033774,6
051902,597,784,1227,2608,051902,0.2289110429447853,0.3006134969325153,0.47047546012269936,5
052000,1196,1630,1809,4635,052000,0.2580366774541532,0.3516720604099245,0.39029126213592236,5
052002,296,339,585,1220,052002,0.24262295081967214,0.2778688524590164,0.47950819672131145,6
052003,707,773,1494,2974,052003,0.23772696704774715,0.2599193006052455,0.5023537323470074,6
052004,1044,1112,2152,4308,052004,0.24233983286908078,0.25812441968430827,0.49953574744661094,6
052100,595,857,1181,2633,052100,0.2259779718951766,0.32548423851120395,0.44853778959361945,5
052101,317,341,657,1315,052101,0.24106463878326997,0.25931558935361215,0.49961977186311785,6
052102,218,299,443,960,052102,0.22708333333333333,0.31145833333333334,0.46145833333333336,5
052103,251,292,416,959,052103,0.26173096976016685,0.3044838373305527,0.4337851929092805,5
052200,434,549,637,1620,052200,0.2679012345679012,0.3388888888888889,0.3932098765432099,5
052201,510,620,1234,2364,052201,0.21573604060913706,0.2622673434856176,0.5219966159052454,6
052203,440,528,1127,2095,052203,0.2100238663484487,0.25202863961813843,0.5379474940334129,6
052204,234,304,551,1089,052204,0.21487603305785125,0.27915518824609736,0.5059687786960514,6
052300,536,887,1147,2570,052300,0.2085603112840467,0.345136186770428,0.4463035019455253,5
052301,303,380,842,1525,052301,0.19868852459016392,0.24918032786885247,0.5521311475409836,6
052303,126,173,330,629,052303,0.20031796502384738,0.27503974562798095,0.5246422893481717,6
052304,644,755,1616,3015,052304,0.21359867330016583,0.2504145936981758,0.5359867330016583,6
052400,130,253,238,621,052400,0.20933977455716588,0.4074074074074074,0.3832528180354267,5
052402,193,191,499,883,052402,0.21857304643261607,0.21630804077010193,0.565118912797282,6
052403,636,771,1548,2955,052403,0.2152284263959391,0.2609137055837564,0.5238578680203045,6
052404,625,874,1780,3279,052404,0.1906068923452272,0.2665446782555657,0.5428484293992071,6
052500,667,671,865,2203,052500,0.30276895142986837,0.30458465728551976,0.3926463912846119,3
052501,563,636,1428,2627,052501,0.21431290445374954,0.24210125618576323,0.5435858393604872,6
052502,427,518,1085,2030,052502,0.2103448275862069,0.25517241379310346,0.5344827586206896,6
052503,107,224,294,625,052503,0.1712,0.3584,0.4704,5
052600,610,911,1068,2589,052600,0.23561220548474315,0.3518733101583623,0.41251448435689453,5
052601,347,420,693,1460,052601,0.23767123287671232,0.2876712328767123,0.47465753424657536,6
052602,125,156,186,467,052602,0.2676659528907923,0.3340471092077088,0.39828693790149894,5
052603,233,337,395,965,052603,0.24145077720207253,0.34922279792746114,0.40932642487046633,5
052700,742,1050,1003,2795,052700,0.26547406082289804,0.3756708407871199,0.3588550983899821,5
052800,283,415,567,1265,052800,0.22371541501976286,0.32806324110671936,0.4482213438735178,5
052900,630,344,335,1309,052900,0.48128342245989303,0.26279602750190983,0.2559205500381971,0
053000,541,760,806,2107,053000,0.25676317038443286,0.36070242050308493,0.3825344091124822,5
053100,1503,952,1087,3542,053100,0.4243365330321852,0.26877470355731226,0.30688876341050253,2
053200,420,646,811,1877,053200,0.2237613212573255,0.34416622269579117,0.4320724560468833,5
053300,931,414,430,1775,053300,0.5245070422535211,0.2332394366197183,0.24225352112676057,0
053400,463,601,540,1604,053400,0.2886533665835411,0.37468827930174564,0.33665835411471323,5
053401,197,287,354,838,053401,0.2350835322195704,0.3424821002386635,0.4224343675417661,5
053500,860,533,499,1892,053500,0.45454545454545453,0.2817124735729387,0.26374207188160675,0
053601,176,282,304,762,053601,0.23097112860892388,0.3700787401574803,0.3989501312335958,5
053700,523,260,230,1013,053700,0.5162882527147088,0.25666337611056267,0.22704837117472854,0
053800,734,1002,1130,2866,053800,0.25610607117934403,0.3496161898115841,0.39427773900907187,5
053900,735,945,1050,2730,053900,0.2692307692307692,0.34615384615384615,0.38461538461538464,5
054000,406,682,702,1790,054000,0.22681564245810057,0.38100558659217876,0.39217877094972065,5
054200,957,1457,1712,4126,054200,0.23194377120698012,0.35312651478429474,0.41492971400872514,5
054300,76,87,193,356,054300,0.21348314606741572,0.2443820224719101,0.5421348314606742,6
054400,384,533,664,1581,054400,0.2428842504743833,0.3371283997469956,0.4199873497786211,5
054500,1248,1173,992,3413,054500,0.3656607090536185,0.3436859068268386,0.29065338411954295,1
054600,575,777,717,2069,054600,0.27791203479942,0.375543740937651,0.34654422426292897,5
054700,1073,1096,1260,3429,054700,0.31291921843102943,0.31962671332750076,0.3674540682414698,3
054800,400,610,832,1842,054800,0.21715526601520088,0.3311617806731813,0.4516829533116178,5
054900,856,1242,1623,3721,054900,0.23004568664337544,0.33378124160171996,0.4361730717549046,5
055000,333,431,556,1320,055000,0.25227272727272726,0.32651515151515154,0.4212121212121212,5
055100,862,1365,1869,4096,055100,0.21044921875,0.333251953125,0.456298828125,5
055200,666,877,1100,2643,055200,0.25198637911464244,0.3318199016269391,0.41619371925841847,5
055300,485,647,1254,2386,055300,0.2032690695725063,0.27116512992455993,0.5255658005029338,6
055400,675,899,1048,2622,055400,0.2574370709382151,0.34286803966437834,0.39969488939740655,5
055500,566,774,1929,3269,055500,0.17314163352707249,0.23676965432854083,0.5900887121443866,6
055600,541,759,1063,2363,055600,0.22894625476089717,0.32120186203977996,0.4498518831993229,5
055700,604,794,1503,2901,055700,0.20820406756290935,0.2736987245777318,0.5180972078593589,6
055800,421,560,704,1685,055800,0.24985163204747773,0.3323442136498516,0.41780415430267065,5
055900,172,191,226,589,055900,0.2920203735144312,0.3242784380305603,0.3837011884550085,5
056000,493,717,878,2088,056000,0.2361111111111111,0.34339080459770116,0.42049808429118773,5
056100,395,506,1123,2024,056100,0.19515810276679843,0.25,0.5548418972332015,6
056200,311,398,574,1283,056200,0.24240062353858144,0.3102104442712393,0.4473889321901793,5
056300,369,577,1126,2072,056300,0.1780888030888031,0.2784749034749035,0.5434362934362934,6
056400,401,547,869,1817,056400,0.22069345074298294,0.3010456796917997,0.4782608695652174,5
056500,478,666,1389,2533,056500,0.18870904066324518,0.2629293328069483,0.5483616265298066,6
056600,380,524,755,1659,056600,0.22905364677516576,0.31585292344786015,0.4550934297769741,5
056700,309,563,904,1776,056700,0.17398648648648649,0.3170045045045045,0.509009009009009,5
056800,542,848,1076,2466,056800,0.2197891321978913,0.34387672343876724,0.43633414436334145,5
056900,206,209,603,1018,056900,0.20235756385068762,0.20530451866404714,0.5923379174852652,6
057000,263,374,606,1243,057000,0.21158487530168946,0.3008849557522124,0.48753016894609813,5
057100,443,559,1214,2216,057100,0.19990974729241878,0.25225631768953066,0.5478339350180506,6
057200,615,778,698,2091,057200,0.29411764705882354,0.3720707795313247,0.33381157340985174,5
057300,259,357,752,1368,057300,0.18932748538011696,0.26096491228070173,0.5497076023391813,6
057400,296,324,439,1059,057400,0.279508970727101,0.3059490084985836,0.4145420207743154,5
057500,418,563,1237,2218,057500,0.1884580703336339,0.2538322813345356,0.5577096483318305,6
057600,285,372,485,1142,057600,0.24956217162872155,0.3257443082311734,0.4246935201401051,5
057700,259,451,598,1308,057700,0.19801223241590213,0.34480122324159024,0.45718654434250766,5
057800,361,395,467,1223,057800,0.29517579721995096,0.32297628781684384,0.38184791496320525,5
057900,290,470,724,1484,057900,0.1954177897574124,0.316711590296496,0.48787061994609165,5
058000,684,924,1068,2676,058000,0.2556053811659193,0.3452914798206278,0.3991031390134529,5
058100,259,355,584,1198,058100,0.21619365609348914,0.29632721202003337,0.48747913188647746,6
058200,661,917,1032,2610,058200,0.2532567049808429,0.3513409961685824,0.3954022988505747,5
058300,299,458,659,1416,058300,0.2111581920903955,0.3234463276836158,0.4653954802259887,5
058400,354,479,621,1454,058400,0.24346629986244842,0.3294360385144429,0.4270976616231087,5
058500,357,515,715,1587,058500,0.22495274102079396,0.32451165721487085,0.4505356017643352,5
058600,277,312,391,980,058600,0.2826530612244898,0.3183673469387755,0.3989795918367347,5
058700,284,440,709,1433,058700,0.19818562456385205,0.30704815073272856,0.4947662247034194,5
058800,305,425,639,1369,058800,0.22279035792549307,0.310445580715851,0.46676406135865595,5
058900,579,966,1318,2863,058900,0.2022354173943416,0.3374083129584352,0.4603562696472232,5
059000,295,452,556,1303,059000,0.2264006139677667,0.3468917881811205,0.42670759785111284,5
059100,744,1298,1947,3989,059100,0.1865129105038857,0.32539483579844575,0.48809225369766857,5
059200,498,694,880,2072,059200,0.24034749034749034,0.33494208494208494,0.4247104247104247,5
059300,558,951,1418,2927,059300,0.19063887939870175,0.32490604714724974,0.48445507345404853,5
059400,160,188,316,664,059400,0.24096385542168675,0.28313253012048195,0.4759036144578313,6
059401,744,1016,1235,2995,059401,0.24841402337228716,0.3392320534223706,0.41235392320534225,5
059402,414,531,925,1870,059402,0.22139037433155082,0.2839572192513369,0.4946524064171123,6
059500,327,603,881,1811,059500,0.18056322473771397,0.33296521258972944,0.4864715626725566,5
059600,391,531,663,1585,059600,0.2466876971608833,0.3350157728706625,0.41829652996845423,5
059800,457,707,908,2072,059800,0.22055984555984556,0.34121621621621623,0.43822393822393824,5
059900,125,219,423,767,059900,0.16297262059973924,0.28552803129074317,0.5514993481095176,6
060000,660,919,1387,2966,060000,0.222521915037087,0.30984490896830746,0.4676331759946055,5
060100,935,1290,1857,4082,060100,0.2290543851053405,0.3160215580597746,0.45492405683488485,5
060101,649,951,1194,2794,060101,0.23228346456692914,0.3403722261989979,0.427344309234073,5
060102,639,839,1078,2556,060102,0.25,0.3282472613458529,0.4217527386541471,5
060200,1056,1558,1371,3985,060200,0.26499372647427855,0.39096612296110417,0.34404015056461734,5
060201,322,349,649,1320,060201,0.24393939393939393,0.2643939393939394,0.49166666666666664,6
060202,324,419,686,1429,060202,0.22673198040587825,0.2932120363890833,0.4800559832050385,6
060300,865,1276,1469,3610,060300,0.23961218836565096,0.35346260387811634,0.4069252077562327,5
060301,390,402,712,1504,060301,0.25930851063829785,0.26728723404255317,0.4734042553191489,6
060302,202,210,490,902,060302,0.22394678492239467,0.2328159645232816,0.5432372505543237,6
060400,1055,1405,1709,4169,060400,0.2530582873590789,0.33701127368673545,0.4099304389541857,5
060500,515,650,611,1776,060500,0.2899774774774775,0.36599099099099097,0.34403153153153154,5
060501,210,324,314,848,060501,0.24764150943396226,0.38207547169811323,0.37028301886792453,5
060502,183,285,272,740,060502,0.2472972972972973,0.38513513513513514,0.3675675675675676,5
060503,209,310,396,915,060503,0.2284153005464481,0.33879781420765026,0.43278688524590164,5
060600,853,1188,1286,3327,060600,0.2563871355575594,0.3570784490532011,0.38653441538923955,5
060601,281,330,478,1089,060601,0.2580348943985308,0.30303030303030304,0.4389348025711662,5
060602,507,638,904,2049,060602,0.24743777452415813,0.31137140068326014,0.44119082479258176,5
060700,509,697,529,1735,060700,0.29337175792507203,0.40172910662824207,0.3048991354466859,5
060701,752,955,1575,3282,060701,0.2291285801340646,0.2909811090798294,0.47989031078610606,6
060702,920,917,1886,3723,060702,0.24711254364759602,0.24630674187483212,0.5065807144775718,6
060800,1046,1474,1932,4452,060800,0.23495058400718777,0.3310871518418688,0.4339622641509434,5
060803,214,214,140,568,060803,0.3767605633802817,0.3767605633802817,0.24647887323943662,1
060804,335,287,241,863,060804,0.388180764774044,0.3325608342989571,0.27925840092699883,1
060900,600,714,570,1884,060900,0.3184713375796178,0.37898089171974525,0.30254777070063693,3
060901,349,484,752,1585,060901,0.22018927444794953,0.3053627760252366,0.4744479495268139,5
060902,203,298,290,791,060902,0.25663716814159293,0.37673830594184576,0.3666245259165613,5
061000,791,1057,1401,3249,061000,0.24345952600800247,0.32533087103724223,0.4312096029547553,5
061002,414,598,857,1869,061002,0.22150882825040127,0.31995719636169073,0.45853397538790797,5
061003,222,281,219,722,061003,0.3074792243767313,0.389196675900277,0.3033240997229917,3
061004,749,918,847,2514,061004,0.2979315831344471,0.36515513126491644,0.33691328560063644,5
061100,1029,1191,1480,3700,061100,0.2781081081081081,0.3218918918918919,0.4,5
061200,1008,1353,1588,3949,061200,0.25525449480881235,0.3426183844011142,0.40212712079007346,5
061300,372,472,294,1138,061300,0.3268892794376098,0.4147627416520211,0.2583479789103691,1
061301,701,866,1633,3200,061301,0.2190625,0.270625,0.5103125,6
061302,985,1005,1675,3665,061302,0.26875852660300137,0.2742155525238745,0.45702592087312416,6
061303,212,185,373,770,061303,0.2753246753246753,0.24025974025974026,0.4844155844155844,6
061400,531,724,520,1775,061400,0.2991549295774648,0.40788732394366195,0.29295774647887324,4
061401,527,783,791,2101,061401,0.25083293669681106,0.3726796763445978,0.37648738695859113,5
061403,608,681,1303,2592,061403,0.2345679012345679,0.26273148148148145,0.5027006172839507,6
061404,330,358,793,1481,061404,0.22282241728561783,0.24172856178257934,0.5354490209318028,6
061500,745,1051,1113,2909,061500,0.2561017531797869,0.36129254039188724,0.38260570642832586,5
061600,1153,1440,2046,4639,061600,0.24854494503125674,0.3104117266652296,0.44104332830351367,5
061601,175,283,411,869,061601,0.20138089758342922,0.3256616800920598,0.47295742232451093,5
061602,135,172,256,563,061602,0.23978685612788633,0.30550621669627,0.4547069271758437,5
061700,201,318,238,757,061700,0.2655217965653897,0.4200792602377807,0.3143989431968296,5
061701,901,886,1857,3644,061701,0.24725576289791437,0.24313940724478594,0.5096048298572997,6
061702,455,508,1070,2033,061702,0.2238071815051648,0.249877029021151,0.5263157894736842,6
061800,2006,2437,3355,7798,061800,0.25724544755065404,0.3125160297512183,0.43023852269812773,5
061900,638,837,1232,2707,061900,0.2356852604359069,0.3091983745844108,0.45511636497968233,5
061901,938,1045,2634,4617,061901,0.20316222655403943,0.22633744855967078,0.5705003248862898,6
061903,544,667,1194,2405,061903,0.2261954261954262,0.27733887733887735,0.4964656964656965,6
062000,1084,1259,2319,4662,062000,0.23251823251823253,0.27005577005577003,0.4974259974259974,6
062100,1140,1273,1442,3855,062100,0.29571984435797666,0.33022049286640726,0.3740596627756161,5
062200,1628,2074,2451,6153,062200,0.26458638062733625,0.3370713473102552,0.3983422720624086,5
062300,519,672,948,2139,062300,0.2426367461430575,0.3141654978962132,0.4431977559607293,5
062400,612,761,885,2258,062400,0.271036315323295,0.33702391496899914,0.39193976970770594,5
062403,610,748,1569,2927,062403,0.208404509736932,0.25555175948069697,0.536043730782371,6
062404,192,204,430,826,062404,0.2324455205811138,0.2469733656174334,0.5205811138014528,6
062405,519,703,1192,2414,062405,0.21499585749792874,0.2912178956089478,0.49378624689312345,6
062406,331,427,775,1533,062406,0.21591650358773645,0.2785388127853881,0.5055446836268754,6
062500,642,938,1107,2687,062500,0.23892817268328992,0.3490882024562709,0.41198362486043916,5
062501,439,432,1258,2129,062501,0.2062000939408173,0.20291216533583842,0.5908877407233443,6
062503,508,568,1395,2471,062503,0.2055847834884662,0.22986645082962365,0.5645487656819101,6
062505,542,533,1220,2295,062505,0.23616557734204793,0.23224400871459694,0.5315904139433552,6
062506,507,507,1520,2534,062506,0.20007892659826362,0.20007892659826362,0.5998421468034728,6
062507,283,386,920,1589,062507,0.17809943360604152,0.24292007551919445,0.578980490874764,6
062508,374,436,1074,1884,062508,0.19851380042462846,0.23142250530785563,0.5700636942675159,6
062509,280,350,828,1458,062509,0.19204389574759945,0.24005486968449932,0.5679012345679012,6
062600,497,823,1074,2394,062600,0.20760233918128654,0.3437761069340017,0.44862155388471175,5
062601,399,417,852,1668,062601,0.2392086330935252,0.25,0.5107913669064749,6
062602,952,995,2396,4343,062602,0.21920331568040524,0.22910430577941515,0.5516923785401796,6
062700,807,1116,1865,3788,062700,0.21304118268215416,0.2946145723336853,0.4923442449841605,6
062800,691,913,1557,3161,062800,0.21860170832015186,0.28883264789623536,0.4925656437836128,6
062900,221,348,573,1142,062900,0.19352014010507881,0.30472854640980734,0.5017513134851138,5
063000,146,266,322,734,063000,0.1989100817438692,0.36239782016348776,0.43869209809264303,5
063200,323,489,716,1528,063200,0.21138743455497383,0.32002617801047123,0.468586387434555,5
063301,112,199,361,672,063301,0.16666666666666666,0.2961309523809524,0.5372023809523809,6
063302,130,211,366,707,063302,0.18387553041018387,0.2984441301272984,0.5176803394625177,6
063500,180,251,589,1020,063500,0.17647058823529413,0.246078431372549,0.5774509803921568,6
063600,129,161,403,693,063600,0.18614718614718614,0.23232323232323232,0.5815295815295816,6
063700,221,318,807,1346,063700,0.16419019316493313,0.2362555720653789,0.5995542347696879,6
063800,425,614,943,1982,063800,0.21442986881937437,0.30978809283551967,0.47578203834510596,5
063900,234,335,606,1175,063900,0.19914893617021276,0.2851063829787234,0.5157446808510638,6
064000,183,173,413,769,064000,0.23797139141742524,0.22496749024707413,0.5370611183355006,6
064101,150,238,459,847,064101,0.1770956316410862,0.2809917355371901,0.5419126328217237,6
064102,37,47,57,141,064102,0.2624113475177305,0.3333333333333333,0.40425531914893614,5
064200,258,348,397,1003,064200,0.2572283150548355,0.3469591226321037,0.39581256231306083,5
064400,222,296,489,1007,064400,0.22045680238331677,0.2939424031777557,0.4856007944389275,6
064500,208,253,530,991,064500,0.20988900100908173,0.25529767911200807,0.5348133198789102,6
064600,450,636,989,2075,064600,0.21686746987951808,0.30650602409638555,0.4766265060240964,5
064800,228,279,477,984,064800,0.23170731707317074,0.28353658536585363,0.4847560975609756,6
065000,423,529,809,1761,065000,0.2402044293015332,0.30039750141964794,0.4593980692788189,5
065200,164,230,376,770,065200,0.21298701298701297,0.2987012987012987,0.4883116883116883,6
065400,405,645,1017,2067,065400,0.19593613933236576,0.31204644412191584,0.49201741654571846,5
065501,52,37,50,139,065501,0.37410071942446044,0.26618705035971224,0.3597122302158273,2
065600,631,878,1326,2835,065600,0.22257495590828924,0.30970017636684305,0.4677248677248677,5
065702,158,216,416,790,065702,0.2,0.27341772151898736,0.5265822784810127,6
065703,217,271,692,1180,065703,0.18389830508474575,0.22966101694915253,0.5864406779661017,6
065800,168,265,496,929,065800,0.18083961248654468,0.2852529601722282,0.5339074273412271,6
065900,143,217,451,811,065900,0.17632552404438964,0.2675709001233046,0.5561035758323057,6
066000,495,670,1097,2262,066000,0.21883289124668434,0.29619805481874445,0.4849690539345712,6
066100,115,181,454,750,066100,0.15333333333333332,0.24133333333333334,0.6053333333333333,6
066200,172,244,383,799,066200,0.21526908635794745,0.3053817271589487,0.4793491864831039,5
066300,251,277,673,1201,066300,0.208992506244796,0.23064113238967526,0.5603663613655288,6
066400,604,1109,1483,3196,066400,0.18898623279098872,0.3469962453066333,0.464017521902378,5
066501,214,349,761,1324,066501,0.16163141993957703,0.263595166163142,0.574773413897281,6
066600,53,50,46,149,066600,0.35570469798657717,0.33557046979865773,0.3087248322147651,3
066701,222,331,633,1186,066701,0.18718381112984822,0.2790893760539629,0.5337268128161888,6
066900,146,226,496,868,066900,0.16820276497695852,0.26036866359447003,0.5714285714285714,6
067000,310,406,574,1290,067000,0.24031007751937986,0.3147286821705426,0.4449612403100775,5
067100,190,219,618,1027,067100,0.18500486854917234,0.21324245374878287,0.6017526777020448,6
067200,154,241,293,688,067200,0.2238372093023256,0.3502906976744186,0.4258720930232558,5
067400,200,329,486,1015,067400,0.19704433497536947,0.32413793103448274,0.47881773399014776,5
067600,192,284,394,870,067600,0.2206896551724138,0.3264367816091954,0.4528735632183908,5
067700,168,217,546,931,067700,0.18045112781954886,0.23308270676691728,0.5864661654135338,6
067800,262,437,545,1244,067800,0.21061093247588425,0.3512861736334405,0.43810289389067525,5
067900,361,465,681,1507,067900,0.23954877239548772,0.3085600530856005,0.45189117451891175,5
068000,534,913,1233,2680,068000,0.19925373134328359,0.34067164179104475,0.46007462686567163,5
068200,439,577,774,1790,068200,0.24525139664804468,0.3223463687150838,0.4324022346368715,5
068300,353,482,726,1561,068300,0.22613709160794362,0.30877642536835365,0.46508648302370276,5
068600,184,239,372,795,068600,0.23144654088050315,0.30062893081761005,0.4679245283018868,5
068700,441,607,1001,2049,068700,0.21522693997071743,0.29624206930209857,0.488530990727184,6
068800,210,247,447,904,068800,0.2323008849557522,0.27323008849557523,0.4944690265486726,6
069000,450,807,872,2129,069000,0.21136683889149835,0.3790511977454204,0.4095819633630813,5
069200,282,383,529,1194,069200,0.23618090452261306,0.32077051926298156,0.44304857621440535,5
069300,286,369,629,1284,069300,0.22274143302180685,0.28738317757009346,0.4898753894080997,6
069400,271,465,540,1276,069400,0.21238244514106583,0.36442006269592475,0.4231974921630094,5
069500,218,249,492,959,069500,0.2273201251303441,0.2596454640250261,0.5130344108446299,6
069601,345,487,760,1592,069601,0.21670854271356785,0.30590452261306533,0.47738693467336685,5
069602,659,760,1422,2841,069602,0.23196057726152763,0.2675114396339317,0.5005279831045406,6
069701,317,441,803,1561,069701,0.20307495195387573,0.2825112107623318,0.5144138372837924,6
069702,362,385,778,1525,069702,0.23737704918032787,0.25245901639344265,0.5101639344262295,6
069800,166,201,362,729,069800,0.22770919067215364,0.2757201646090535,0.49657064471879286,6
070000,182,259,445,886,070000,0.2054176072234763,0.29232505643340856,0.5022573363431151,6
070100,493,657,687,1837,070100,0.2683723462166576,0.35764833968426785,0.3739793140990746,5
070101,513,659,1124,2296,070101,0.22343205574912892,0.28702090592334495,0.4895470383275261,6
070102,376,511,763,1650,070102,0.22787878787878788,0.3096969696969697,0.4624242424242424,5
070200,571,758,631,1960,070200,0.2913265306122449,0.386734693877551,0.32193877551020406,5
070201,854,1207,1992,4053,070201,0.21070811744386875,0.29780409573155686,0.4914877868245744,6
070202,54,56,65,175,070202,0.30857142857142855,0.32,0.37142857142857144,3
070203,37,53,48,138,070203,0.26811594202898553,0.38405797101449274,0.34782608695652173,5
070300,1049,1309,1515,3873,070300,0.270849470694552,0.3379808933643171,0.3911696359411309,5
070301,677,858,1425,2960,070301,0.2287162162162162,0.28986486486486485,0.4814189189189189,6
070400,870,1138,1143,3151,070400,0.27610282450015866,0.3611551888289432,0.36274198667089813,5
070401,385,461,843,1689,070401,0.22794552989934871,0.2729425695677916,0.4991119005328597,6
070500,633,849,873,2355,070500,0.26878980891719745,0.36050955414012736,0.37070063694267513,5
070600,468,674,809,1951,070600,0.2398769861609431,0.345463864684777,0.41465914915427987,5
070601,869,943,1309,3121,070601,0.2784363985901955,0.30214674783723167,0.4194168535725729,5
070602,248,238,361,847,070602,0.29279811097992914,0.2809917355371901,0.42621015348288077,6
070700,466,620,989,2075,070700,0.22457831325301206,0.2987951807228916,0.4766265060240964,6
070701,585,587,793,1965,070701,0.29770992366412213,0.29872773536895675,0.4035623409669211,6
070702,518,561,964,2043,070702,0.2535487028879099,0.2745961820851689,0.4718551150269212,6
070800,1270,1793,1685,4748,070800,0.2674810446503791,0.37763268744734624,0.3548862679022746,5
070900,994,1140,1944,4078,070900,0.24374693477194703,0.27954879843060326,0.4767042667974497,6
071000,335,511,453,1299,071000,0.25789068514241725,0.3933795227097768,0.34872979214780603,5
071100,355,459,1311,2125,071100,0.16705882352941176,0.216,0.6169411764705882,6
071303,292,397,1296,1985,071303,0.14710327455919395,0.2,0.652896725440806,6
071304,402,527,1229,2158,071304,0.18628359592215013,0.24420759962928637,0.5695088044485634,6
071305,237,373,1121,1731,071305,0.1369150779896014,0.21548238012709417,0.6476025418833045,6
071306,383,471,1197,2051,071306,0.18673817649926866,0.2296440760604583,0.5836177474402731,6
071600,46,38,46,130,071600,0.35384615384615387,0.2923076923076923,0.35384615384615387,2
071701,382,526,1027,1935,071701,0.1974160206718346,0.2718346253229974,0.530749354005168,6
071702,347,426,857,1630,071702,0.21288343558282208,0.26134969325153373,0.5257668711656441,6
071900,218,320,467,1005,071900,0.21691542288557214,0.31840796019900497,0.4646766169154229,5
072000,606,841,899,2346,072000,0.25831202046035806,0.35848252344416026,0.3832054560954817,5
072100,1277,1485,2322,5084,072100,0.2511801730920535,0.29209284028324156,0.45672698662470496,6
072200,855,1149,1338,3342,072200,0.25583482944344704,0.34380610412926393,0.400359066427289,5
072300,618,753,1110,2481,072300,0.24909310761789602,0.30350665054413545,0.44740024183796856,5
072400,483,671,714,1868,072400,0.25856531049250536,0.35920770877944325,0.3822269807280514,5
072500,384,593,408,1385,072500,0.2772563176895307,0.42815884476534294,0.2945848375451264,4
072600,577,918,967,2462,072600,0.23436230706742486,0.3728675873273761,0.39277010560519904,5
072700,368,559,559,1486,072700,0.24764468371467024,0.37617765814266485,0.37617765814266485,5
072800,649,997,1293,2939,072800,0.22082340932289896,0.33923103096291257,0.43994555971418847,5
072900,153,152,346,651,072900,0.2350230414746544,0.23348694316436253,0.5314900153609831,6
073000,700,965,876,2541,073000,0.27548209366391185,0.37977174340810704,0.3447461629279811,5
073100,120,160,368,648,073100,0.18518518518518517,0.24691358024691357,0.5679012345679012,6
073200,252,355,437,1044,073200,0.2413793103448276,0.3400383141762452,0.4185823754789272,5
073400,206,371,434,1011,073400,0.20375865479723046,0.3669634025717112,0.42927794263105834,5
073500,175,216,215,606,073500,0.2887788778877888,0.3564356435643564,0.3547854785478548,5
073600,370,499,545,1414,073600,0.26166902404526166,0.35289957567185287,0.3854314002828854,5
073700,136,203,636,975,073700,0.13948717948717948,0.2082051282051282,0.6523076923076923,6
073800,353,490,578,1421,073800,0.24841660802251936,0.3448275862068966,0.4067558057705841,5
073900,271,327,1212,1810,073900,0.14972375690607734,0.18066298342541437,0.6696132596685083,6
074000,572,852,692,2116,074000,0.27032136105860116,0.40264650283553877,0.3270321361058601,5
074100,199,298,779,1276,074100,0.15595611285266459,0.2335423197492163,0.6105015673981191,6
074200,342,499,649,1490,074200,0.2295302013422819,0.33489932885906043,0.4355704697986577,5
074300,295,394,744,1433,074300,0.20586182833217026,0.2749476622470342,0.5191905094207956,6
074400,271,301,512,1084,074400,0.25,0.27767527675276754,0.47232472324723246,6
074500,315,414,552,1281,074500,0.2459016393442623,0.3231850117096019,0.4309133489461358,5
074600,225,265,388,878,074600,0.25626423690205014,0.30182232346241455,0.4419134396355353,5
074700,254,369,665,1288,074700,0.1972049689440994,0.2864906832298137,0.5163043478260869,6
074800,195,298,418,911,074800,0.21405049396267836,0.32711306256860595,0.4588364434687157,5
074900,131,146,480,757,074900,0.17305151915455746,0.1928665785997358,0.6340819022457067,6
075000,571,747,779,2097,075000,0.2722937529804483,0.3562231759656652,0.3714830710538865,5
075200,118,134,229,481,075200,0.24532224532224534,0.2785862785862786,0.4760914760914761,6
075400,196,223,287,706,075400,0.2776203966005666,0.31586402266288954,0.4065155807365439,5
075600,250,290,421,961,075600,0.2601456815816857,0.3017689906347555,0.4380853277835588,5
075701,262,351,1245,1858,075701,0.14101184068891282,0.18891280947255112,0.670075349838536,6
075702,248,323,1122,1693,075702,0.14648552864737152,0.19078558771411694,0.6627288836385116,6
075800,210,271,389,870,075800,0.2413793103448276,0.3114942528735632,0.4471264367816092,5
076000,578,728,764,2070,076000,0.2792270531400966,0.3516908212560386,0.3690821256038647,5
076200,499,595,578,1672,076200,0.298444976076555,0.35586124401913877,0.3456937799043062,5
076400,436,673,707,1816,076400,0.24008810572687225,0.3705947136563877,0.3893171806167401,5
076600,252,399,349,1000,076600,0.252,0.399,0.349,5
076800,398,505,481,1384,076800,0.2875722543352601,0.36488439306358383,0.3475433526011561,5
076901,238,307,1140,1685,076901,0.14124629080118695,0.18219584569732938,0.6765578635014837,6
076902,119,148,397,664,076902,0.17921686746987953,0.22289156626506024,0.5978915662650602,6
077000,394,496,505,1395,077000,0.2824372759856631,0.35555555555555557,0.36200716845878134,5
077200,416,589,602,1607,077200,0.25886745488487867,0.36652146857498447,0.3746110765401369,5
077300,190,273,699,1162,077300,0.16351118760757316,0.23493975903614459,0.6015490533562823,6
077400,372,608,565,1545,077400,0.2407766990291262,0.3935275080906149,0.3656957928802589,5
077500,195,242,496,933,077500,0.2090032154340836,0.25937834941050375,0.5316184351554126,6
077600,394,563,870,1827,077600,0.21565407772304324,0.30815544608648054,0.47619047619047616,5
077902,327,434,894,1655,077902,0.19758308157099697,0.2622356495468278,0.5401812688821752,6
077903,233,328,552,1113,077903,0.20934411500449238,0.29469901168014373,0.49595687331536387,6
077904,394,613,927,1934,077904,0.20372285418821096,0.3169596690796277,0.4793174767321613,5
077905,185,243,586,1014,077905,0.18244575936883628,0.23964497041420119,0.5779092702169625,6
077906,261,338,587,1186,077906,0.22006745362563238,0.28499156829679595,0.49494097807757165,6
077907,243,298,449,990,077907,0.24545454545454545,0.301010101010101,0.4535353535353535,5
077908,249,382,507,1138,077908,0.218804920913884,0.335676625659051,0.44551845342706503,5
078000,447,628,689,1764,078000,0.2534013605442177,0.35600907029478457,0.39058956916099774,5
078200,435,746,562,1743,078200,0.2495697074010327,0.4279977051061388,0.32243258749282844,5
078400,244,436,428,1108,078400,0.22021660649819494,0.3935018050541516,0.3862815884476534,5
078600,512,866,752,2130,078600,0.2403755868544601,0.40657276995305164,0.3530516431924883,5
078800,603,1075,664,2342,078800,0.25747224594363793,0.4590093936806149,0.28351836037574724,4
079000,749,1286,1008,3043,079000,0.24613867893526126,0.42260926717055536,0.3312520538941834,5
079200,614,906,754,2274,079200,0.2700087950747581,0.39841688654353563,0.33157431838170626,5
079300,38,37,41,116,079300,0.3275862068965517,0.31896551724137934,0.35344827586206895,3
079400,216,404,238,858,079400,0.2517482517482518,0.47086247086247085,0.2773892773892774,4
079601,553,787,806,2146,079601,0.2576887232059646,0.36672879776328055,0.37558247903075487,5
079602,540,801,675,2016,079602,0.26785714285714285,0.39732142857142855,0.33482142857142855,5
079701,598,635,929,2162,079701,0.2765957446808511,0.2937095282146161,0.4296947271045328,6
079702,523,558,446,1527,079702,0.3425016371971185,0.3654223968565815,0.2920759659462999,1
079801,336,502,705,1543,079801,0.21775761503564484,0.32534024627349317,0.45690213869086194,5
079802,661,1010,1069,2740,079802,0.24124087591240875,0.3686131386861314,0.39014598540145984,5
079900,427,407,465,1299,079900,0.3287143956889915,0.31331793687451887,0.3579676674364896,3
080000,368,589,668,1625,080000,0.22646153846153846,0.36246153846153845,0.41107692307692306,5
080100,1217,1756,1853,4826,080100,0.25217571487774554,0.3638624119353502,0.3839618731869043,5
080103,486,460,1069,2015,080103,0.2411910669975186,0.228287841191067,0.5305210918114144,6
080104,382,394,795,1571,080104,0.2431572246976448,0.2507956715467855,0.5060471037555697,6
080200,820,1122,1179,3121,080200,0.26273630246715796,0.3595001602050625,0.37776353732777956,5
080201,1094,1409,2057,4560,080201,0.23991228070175438,0.3089912280701754,0.45109649122807016,5
080202,603,666,1041,2310,080202,0.261038961038961,0.2883116883116883,0.45064935064935063,6
080300,1197,1404,1472,4073,080300,0.29388657009575253,0.3447090596611834,0.3614043702430641,5
080301,500,500,475,1475,080301,0.3389830508474576,0.3389830508474576,0.3220338983050847,3
080302,362,398,537,1297,080302,0.2791056283731688,0.30686198920585966,0.41403238242097146,5
080400,378,595,522,1495,080400,0.2528428093645485,0.3979933110367893,0.3491638795986622,5
080401,380,422,448,1250,080401,0.304,0.3376,0.3584,3
080402,368,466,417,1251,080402,0.2941646682653877,0.37250199840127896,0.3333333333333333,5
080501,368,464,534,1366,080501,0.26939970717423134,0.3396778916544656,0.39092240117130306,5
080502,573,715,691,1979,080502,0.28954017180394137,0.36129358261748357,0.34916624557857506,5
080600,789,1130,1335,3254,080600,0.24247080516287645,0.34726490473263677,0.4102642901044868,5
080700,335,420,627,1382,080700,0.24240231548480462,0.30390738060781475,0.45369030390738063,5
080800,200,221,224,645,080800,0.31007751937984496,0.3426356589147287,0.34728682170542635,3
080900,848,1131,1785,3764,080900,0.2252922422954304,0.3004782146652497,0.47422954303931986,5
081000,1054,1589,1601,4244,081000,0.24835061262959474,0.37441093308199813,0.3772384542884072,5
081101,512,621,691,1824,081101,0.2807017543859649,0.3404605263157895,0.3788377192982456,5
081102,343,448,535,1326,081102,0.25867269984917046,0.3378582202111614,0.4034690799396682,5
081400,546,926,925,2397,081400,0.22778473091364204,0.3863162286191072,0.3858990404672507,5
081600,275,464,418,1157,081600,0.23768366464995677,0.4010371650821089,0.3612791702679343,5
081800,881,1398,1311,3590,081800,0.24540389972144847,0.3894150417827298,0.3651810584958217,5
082000,538,953,707,2198,082000,0.24476797088262056,0.4335759781619654,0.321656050955414,5
082001,463,723,613,1799,082001,0.2573652028904947,0.4018899388549194,0.3407448582545859,5
082002,138,199,197,534,082002,0.25842696629213485,0.37265917602996257,0.36891385767790263,5
082200,753,1242,888,2883,082200,0.2611862643080125,0.4308012486992716,0.30801248699271594,5
082400,496,884,574,1954,082400,0.2538382804503582,0.4524053224155578,0.2937563971340839,4
082600,662,1146,791,2599,082600,0.2547133512889573,0.4409388226240862,0.30434782608695654,5
082800,483,800,484,1767,082800,0.2733446519524618,0.4527447651386531,0.2739105829088851,4
083000,741,1195,734,2670,083000,0.27752808988764044,0.44756554307116103,0.27490636704119853,4
083200,248,435,433,1116,083200,0.2222222222222222,0.3897849462365591,0.38799283154121866,5
083400,200,342,369,911,083400,0.21953896816684962,0.3754116355653128,0.40504939626783754,5
083600,211,329,329,869,083600,0.2428078250863061,0.378596087456847,0.378596087456847,5
083700,540,591,741,1872,083700,0.28846153846153844,0.3157051282051282,0.3958333333333333,5
083800,630,1054,1244,2928,083800,0.2151639344262295,0.3599726775956284,0.4248633879781421,5
084000,1326,2246,2244,5816,084000,0.22799174690508942,0.3861760660247593,0.3858321870701513,5
084500,744,814,798,2356,084500,0.3157894736842105,0.3455008488964346,0.3387096774193548,3
084600,226,356,365,947,084600,0.23864836325237593,0.3759239704329461,0.38542766631467795,5
084601,218,388,504,1110,084601,0.1963963963963964,0.34954954954954953,0.4540540540540541,5
084602,86,176,199,461,084602,0.18655097613882862,0.38177874186550975,0.4316702819956616,5
084800,202,350,318,870,084800,0.23218390804597702,0.40229885057471265,0.36551724137931035,5
084900,784,817,582,2183,084900,0.35913879981676594,0.37425561154374715,0.26660558863948697,1
085000,429,617,688,1734,085000,0.24740484429065743,0.3558246828143022,0.39677047289504036,5
085200,37,48,42,127,085200,0.29133858267716534,0.3779527559055118,0.33070866141732286,5
085300,576,574,549,1699,085300,0.33902295467922305,0.33784579164214246,0.3231312536786345,3
085400,255,373,323,951,085400,0.26813880126182965,0.3922187171398528,0.33964248159831756,5
085500,614,697,761,2072,085500,0.29633204633204635,0.3363899613899614,0.3672779922779923,5
085600,415,673,613,1701,085600,0.24397413286302175,0.3956496178718401,0.36037624926513817,5
085700,640,688,588,1916,085700,0.33402922755741127,0.35908141962421714,0.3068893528183716,3
085800,293,427,416,1136,085800,0.2579225352112676,0.37588028169014087,0.36619718309859156,5
085900,712,704,625,2041,085900,0.3488486036256737,0.34492895639392457,0.3062224399804018,3
086000,575,849,783,2207,086000,0.26053466243769824,0.38468509288627095,0.3547802446760308,5
086100,271,320,279,870,086100,0.3114942528735632,0.367816091954023,0.32068965517241377,3
086200,326,561,451,1338,086200,0.2436472346786248,0.4192825112107623,0.33707025411061287,5
086300,783,771,732,2286,086300,0.3425196850393701,0.33727034120734906,0.32020997375328086,3
086400,434,782,792,2008,086400,0.21613545816733068,0.3894422310756972,0.3944223107569721,5
086500,438,417,447,1302,086500,0.33640552995391704,0.32027649769585254,0.3433179723502304,3
086600,273,562,465,1300,086600,0.21,0.4323076923076923,0.3576923076923077,5
086800,330,568,437,1335,086800,0.24719101123595505,0.4254681647940075,0.32734082397003744,5
086900,264,252,240,756,086900,0.3492063492063492,0.3333333333333333,0.31746031746031744,3
087000,632,1111,1075,2818,087000,0.22427253371185238,0.3942512420156139,0.3814762242725337,5
087100,314,340,266,920,087100,0.34130434782608693,0.3695652173913043,0.2891304347826087,1
087200,292,491,486,1269,087200,0.23010244286840031,0.38691883372734437,0.3829787234042553,5
087401,310,513,402,1225,087401,0.2530612244897959,0.41877551020408166,0.32816326530612244,5
087600,146,275,265,686,087600,0.21282798833819241,0.4008746355685131,0.38629737609329445,5
087800,247,468,387,1102,087800,0.22413793103448276,0.4246823956442831,0.3511796733212341,5
088000,825,1404,1284,3513,088000,0.23484201537147736,0.3996584116140051,0.3654995730145175,5
088200,588,978,817,2383,088200,0.24674779689467058,0.4104070499370541,0.3428451531682753,5
088400,1037,1666,1944,4647,088400,0.22315472347751236,0.35851086722616743,0.4183344092963202,5
088600,419,763,507,1689,088600,0.24807578448786263,0.4517465956187093,0.30017761989342806,5
088800,387,628,493,1508,088800,0.256631299734748,0.41644562334217505,0.3269230769230769,5
088901,922,1102,1355,3379,088901,0.2728617934300089,0.3261319917135247,0.4010062148564664,5
089000,982,1597,1448,4027,089000,0.24385398559721877,0.39657313136329775,0.3595728830394835,5
089200,1103,1579,2013,4695,089200,0.2349307774227902,0.3363152289669862,0.42875399361022365,5
089400,316,518,351,1185,089400,0.26666666666666666,0.4371308016877637,0.29620253164556964,4
089600,350,621,438,1409,089600,0.248403122782115,0.44073811213626685,0.3108587650816182,5
089800,209,310,294,813,089800,0.2570725707257073,0.3813038130381304,0.36162361623616235,5
090000,912,1523,1341,3776,090000,0.24152542372881355,0.4033368644067797,0.3551377118644068,5
090200,310,457,370,1137,090200,0.2726473175021988,0.4019349164467898,0.3254177660510114,5
090600,433,701,309,1443,090600,0.30006930006930005,0.4857934857934858,0.21413721413721415,1
090700,172,183,277,632,090700,0.2721518987341772,0.28955696202531644,0.43829113924050633,6
090800,398,500,265,1163,090800,0.3422184006878762,0.4299226139294927,0.22785898538263114,1
091000,670,999,549,2218,091000,0.30207394048692515,0.4504057709648332,0.24752028854824165,1
091200,678,987,458,2123,091200,0.3193593970796043,0.4649081488459727,0.21573245407442299,1
091600,413,632,438,1483,091600,0.2784895482130816,0.4261631827376939,0.29534726904922454,4
091601,225,348,946,1519,091601,0.14812376563528637,0.22909809084924293,0.6227781435154707,6
091602,43,52,41,136,091602,0.3161764705882353,0.38235294117647056,0.3014705882352941,3
091800,360,532,455,1347,091800,0.267260579064588,0.3949517446176689,0.33778767631774315,5
091900,479,576,721,1776,091900,0.2697072072072072,0.32432432432432434,0.40596846846846846,5
092000,635,956,868,2459,092000,0.258235054900366,0.3887759251728345,0.3529890199267995,5
092200,436,720,1147,2303,092200,0.18931828050369084,0.3126356925749023,0.49804602692140687,5
092400,336,489,376,1201,092400,0.279766860949209,0.4071606994171524,0.3130724396336386,5
092500,348,503,486,1337,092500,0.26028421839940163,0.37621540762902017,0.36350037397157814,5
092800,504,753,1290,2547,092800,0.1978798586572438,0.2956419316843345,0.5064782096584217,6
092900,557,781,1000,2338,092900,0.23823781009409753,0.33404619332763047,0.42771599657827203,5
093000,435,630,717,1782,093000,0.2441077441077441,0.35353535353535354,0.40235690235690236,5
093200,126,247,206,579,093200,0.21761658031088082,0.4265975820379965,0.35578583765112265,5
093400,201,394,447,1042,093400,0.1928982725527831,0.3781190019193858,0.4289827255278311,5
093401,279,339,861,1479,093401,0.18864097363083165,0.22920892494929007,0.5821501014198783,6
093402,220,400,690,1310,093402,0.16793893129770993,0.3053435114503817,0.5267175572519084,5
093600,172,312,239,723,093600,0.23789764868603042,0.4315352697095436,0.330567081604426,5
093800,561,964,1142,2667,093800,0.21034870641169853,0.36145481814773156,0.42819647544056993,5
093900,396,561,761,1718,093900,0.23050058207217694,0.3265424912689173,0.4429569266589057,5
094000,228,275,337,840,094000,0.2714285714285714,0.3273809523809524,0.4011904761904762,5
094201,270,412,527,1209,094201,0.22332506203473945,0.34077750206782464,0.4358974358974359,5
094202,372,489,595,1456,094202,0.2554945054945055,0.3358516483516483,0.40865384615384615,5
094203,526,872,989,2387,094203,0.2203602848764139,0.3653121072475911,0.414327607875995,5
094401,352,577,586,1515,094401,0.23234323432343235,0.3808580858085809,0.38679867986798677,5
094402,357,507,355,1219,094402,0.29286300246103364,0.4159146841673503,0.2912223133716161,4
094500,400,482,725,1607,094500,0.24891101431238333,0.29993777224642193,0.4511512134411948,6
094600,169,274,383,826,094600,0.2046004842615012,0.33171912832929784,0.463680387409201,5
094700,259,325,394,978,094700,0.26482617586912066,0.3323108384458078,0.40286298568507156,5
095000,317,597,532,1446,095000,0.21922544951590595,0.41286307053941906,0.367911479944675,5
095400,908,1416,1507,3831,095400,0.23701383450796137,0.36961628817541115,0.39336987731662754,5
095600,424,694,642,1760,095600,0.2409090909090909,0.39431818181818185,0.36477272727272725,5
095800,352,590,642,1584,095800,0.2222222222222222,0.37247474747474746,0.4053030303030303,5
096000,49,54,48,151,096000,0.32450331125827814,0.3576158940397351,0.31788079470198677,3
096200,191,298,304,793,096200,0.2408575031525851,0.37578814627994955,0.3833543505674653,5
096400,574,992,957,2523,096400,0.22750693618707887,0.3931827189853349,0.3793103448275862,5
096600,281,383,397,1061,096600,0.2648444863336475,0.3609802073515551,0.37417530631479734,5
096800,184,296,323,803,096800,0.22914072229140722,0.3686176836861768,0.40224159402241594,5
097000,255,379,458,1092,097000,0.23351648351648352,0.34706959706959706,0.4194139194139194,5
097202,282,457,262,1001,097202,0.2817182817182817,0.4565434565434565,0.26173826173826176,4
097203,623,949,544,2116,097203,0.2944234404536862,0.44848771266540643,0.2570888468809074,4
097204,298,428,445,1171,097204,0.25448334756618274,0.3654995730145175,0.38001707941929974,5
097300,217,239,420,876,097300,0.24771689497716895,0.2728310502283105,0.4794520547945205,6
097400,272,429,381,1082,097400,0.2513863216266174,0.39648798521256934,0.3521256931608133,5
098100,238,261,476,975,098100,0.2441025641025641,0.2676923076923077,0.4882051282051282,6
098200,504,726,519,1749,098200,0.2881646655231561,0.41509433962264153,0.2967409948542024,4
098400,182,311,396,889,098400,0.2047244094488189,0.3498312710911136,0.4454443194600675,5
098600,305,499,492,1296,098600,0.2353395061728395,0.38503086419753085,0.37962962962962965,5
098700,222,283,563,1068,098700,0.20786516853932585,0.2649812734082397,0.5271535580524345,6
098800,305,478,545,1328,098800,0.22966867469879518,0.35993975903614456,0.41039156626506024,5
099000,157,302,286,745,099000,0.21073825503355706,0.4053691275167785,0.3838926174496644,5
099100,502,671,1427,2600,099100,0.1930769230769231,0.2580769230769231,0.5488461538461539,6
099200,552,872,771,2195,099200,0.25148063781321184,0.39726651480637815,0.35125284738041,5
099400,184,383,403,970,099400,0.18969072164948453,0.39484536082474225,0.4154639175257732,5
099600,321,595,660,1576,099600,0.2036802030456853,0.37753807106598986,0.41878172588832485,5
099701,219,275,637,1131,099701,0.19363395225464192,0.24314765694076038,0.5632183908045977,6
099703,270,395,797,1462,099703,0.18467852257181944,0.2701778385772914,0.5451436388508892,6
099704,450,547,1300,2297,099704,0.195907705703091,0.23813670004353504,0.5659555942533739,6
099705,213,271,512,996,099705,0.21385542168674698,0.2720883534136546,0.5140562248995983,6
099800,395,611,807,1813,099800,0.21787093215664644,0.3370104798676227,0.44511858797573084,5
099801,561,996,849,2406,099801,0.23316708229426433,0.4139650872817955,0.35286783042394015,5
099802,362,600,541,1503,099802,0.24085163007318697,0.3992015968063872,0.35994677312042583,5
099900,61,57,35,153,099900,0.39869281045751637,0.37254901960784315,0.22875816993464052,1
100000,298,395,505,1198,100000,0.24874791318864775,0.3297161936560935,0.42153589315525875,5
100100,583,863,855,2301,100100,0.25336810082572797,0.3750543242068666,0.37157757496740546,5
100200,423,691,711,1825,100200,0.23178082191780822,0.3786301369863014,0.38958904109589043,5
100300,535,904,826,2265,100300,0.23620309050772628,0.3991169977924945,0.36467991169977926,5
100400,594,928,1084,2606,100400,0.22793553338449732,0.3561013046815042,0.41596316193399846,5
100600,803,1316,1438,3557,100600,0.22575203823446724,0.36997469777902725,0.4042732639865055,5
100700,338,522,720,1580,100700,0.2139240506329114,0.330379746835443,0.45569620253164556,5
100800,757,1123,1290,3170,100800,0.238801261829653,0.3542586750788643,0.4069400630914827,5
100801,236,325,364,925,100801,0.25513513513513514,0.35135135135135137,0.3935135135135135,5
100802,571,956,849,2376,100802,0.24031986531986532,0.40235690235690236,0.3573232323232323,5
100900,609,827,715,2151,100900,0.28312412831241285,0.38447233844723383,0.3324035332403533,5
101000,768,936,1272,2976,101000,0.25806451612903225,0.31451612903225806,0.4274193548387097,5
101001,867,1278,940,3085,101001,0.28103727714748783,0.41426256077795787,0.3047001620745543,5
101002,363,430,584,1377,101002,0.2636165577342048,0.31227305737109656,0.4241103848946986,5
101100,115,125,155,395,101100,0.2911392405063291,0.31645569620253167,0.3924050632911392,5
101200,242,354,420,1016,101200,0.23818897637795275,0.3484251968503937,0.41338582677165353,5
101300,334,413,328,1075,101300,0.31069767441860463,0.3841860465116279,0.30511627906976746,3
101400,438,654,833,1925,101400,0.22753246753246753,0.33974025974025973,0.43272727272727274,5
101600,432,619,527,1578,101600,0.2737642585551331,0.39226869455006336,0.33396704689480355,5
101700,1036,1461,2035,4532,101700,0.22859664607237423,0.3223742277140335,0.44902912621359226,5
101800,762,1211,1508,3481,101800,0.21890261419132434,0.34788853777650103,0.4332088480321747,5
101900,858,1122,1464,3444,101900,0.24912891986062718,0.32578397212543553,0.4250871080139373,5
102000,589,948,927,2464,102000,0.2390422077922078,0.3847402597402597,0.3762175324675325,5
102100,282,386,404,1072,102100,0.2630597014925373,0.36007462686567165,0.376865671641791,5
102200,651,930,822,2403,102200,0.27091136079900124,0.38701622971285893,0.34207240948813983,5
102400,230,328,425,983,102400,0.23397761953204477,0.3336724313326551,0.4323499491353001,5
102600,263,407,504,1174,102600,0.22402044293015333,0.34667802385008517,0.4293015332197615,5
102800,153,256,339,748,102800,0.20454545454545456,0.3422459893048128,0.4532085561497326,5
102900,257,320,580,1157,102900,0.22212618841832324,0.27657735522904064,0.5012964563526361,6
103201,595,912,599,2106,103201,0.2825261158594492,0.43304843304843305,0.28442545109211775,4
103202,547,740,757,2044,103202,0.26761252446183953,0.36203522504892366,0.3703522504892368,5
103300,338,421,758,1517,103300,0.2228081740276862,0.27752142386288725,0.4996704021094265,6
103400,436,627,423,1486,103400,0.2934051144010767,0.42193808882907136,0.28465679676985195,4
103900,437,612,1131,2180,103900,0.20045871559633027,0.28073394495412846,0.5188073394495413,6
104700,509,713,1125,2347,104700,0.21687260332339156,0.3037920749893481,0.47933532168726034,5
105801,819,1263,1319,3401,105801,0.24081152602175832,0.3713613643046163,0.3878271096736254,5
105804,656,1003,1101,2760,105804,0.23768115942028986,0.36340579710144927,0.39891304347826084,5
105900,292,375,750,1417,105900,0.20606916019760058,0.2646436132674665,0.529287226534933,6
107000,107,101,128,336,107000,0.31845238095238093,0.3005952380952381,0.38095238095238093,3
107201,291,368,642,1301,107201,0.22367409684857803,0.2828593389700231,0.49346656418139895,6
107202,55,57,55,167,107202,0.32934131736526945,0.3413173652694611,0.32934131736526945,3
107800,324,535,925,1784,107800,0.18161434977578475,0.2998878923766816,0.5184977578475336,6
108500,204,263,500,967,108500,0.2109617373319545,0.27197518097207857,0.5170630816959669,6
109300,216,288,593,1097,109300,0.19690063810391978,0.2625341841385597,0.5405651777575206,6
109700,158,188,424,770,109700,0.2051948051948052,0.24415584415584415,0.5506493506493506,6
109800,200,334,212,746,109800,0.2680965147453083,0.4477211796246649,0.28418230563002683,4
109900,241,393,651,1285,109900,0.18754863813229572,0.3058365758754864,0.5066147859922179,5
110003,352,413,721,1486,110003,0.23687752355316286,0.2779273216689098,0.4851951547779273,6
110004,164,214,383,761,110004,0.21550591327201052,0.2812089356110381,0.5032851511169514,6
110005,214,240,374,828,110005,0.2584541062801932,0.2898550724637681,0.45169082125603865,6
110101,298,278,929,1505,110101,0.19800664451827243,0.18471760797342193,0.6172757475083056,6
110102,481,577,1493,2551,110102,0.18855350842806742,0.2261858094864759,0.5852606820854567,6
110200,569,505,1568,2642,110200,0.2153671461014383,0.1911430734292203,0.5934897804693414,6
110300,548,547,1553,2648,110300,0.20694864048338368,0.20657099697885195,0.5864803625377644,6
110400,479,741,556,1776,110400,0.2697072072072072,0.4172297297297297,0.3130630630630631,5
110401,264,302,845,1411,110401,0.18710134656272148,0.21403260099220411,0.5988660524450744,6
110402,341,348,1013,1702,110402,0.20035252643948295,0.2044653349001175,0.5951821386603995,6
110501,349,324,1010,1683,110501,0.2073677956030897,0.1925133689839572,0.6001188354129531,6
110502,337,346,916,1599,110502,0.21075672295184492,0.21638524077548468,0.5728580362726704,6
110600,1346,1439,2666,5451,110600,0.24692716932672903,0.2639882590350394,0.4890845716382315,6
110801,221,249,685,1155,110801,0.19134199134199134,0.21558441558441557,0.5930735930735931,6
110803,724,623,1757,3104,110803,0.23324742268041238,0.20070876288659795,0.5660438144329897,6
110901,265,354,913,1532,110901,0.17297650130548303,0.2310704960835509,0.5959530026109661,6
110902,528,686,1049,2263,110902,0.23331860362350862,0.3031374281926646,0.46354396818382676,5
111000,392,577,367,1336,111000,0.2934131736526946,0.4318862275449102,0.2747005988023952,4
111001,256,312,656,1224,111001,0.20915032679738563,0.2549019607843137,0.5359477124183006,6
111002,580,796,1114,2490,111002,0.23293172690763053,0.3196787148594378,0.44738955823293175,5
111100,1175,1592,1874,4641,111100,0.25317819435466493,0.34302951950010774,0.40379228614522733,5
111201,514,712,788,2014,111201,0.25521350546176763,0.3535253227408143,0.3912611717974181,5
111202,562,774,1347,2683,111202,0.2094670145359672,0.28848304137159897,0.5020499440924339,6
111300,596,746,1794,3136,111300,0.19005102040816327,0.2378826530612245,0.5720663265306123,6
111401,174,181,486,841,111401,0.20689655172413793,0.21521997621878716,0.5778834720570749,6
111402,541,588,1633,2762,111402,0.19587255611875454,0.21288921071687184,0.5912382331643736,6
111503,450,579,1230,2259,111503,0.199203187250996,0.25630810092961487,0.5444887118193891,6
111504,156,154,386,696,111504,0.22413793103448276,0.22126436781609196,0.5545977011494253,6
111505,658,962,1579,3199,111505,0.20568927789934355,0.30071897467958736,0.4935917474210691,5
111506,356,445,878,1679,111506,0.2120309708159619,0.26503871351995234,0.5229303156640858,6
111600,328,516,477,1321,111600,0.24829674489023468,0.3906131718395155,0.36109008327024983,5
111601,379,424,1020,1823,111601,0.20789906747120132,0.23258365331870542,0.5595172792100932,6
111602,371,347,960,1678,111602,0.22109654350417163,0.2067938021454112,0.5721096543504172,6
111701,608,627,1561,2796,111701,0.21745350500715308,0.22424892703862662,0.5582975679542204,6
111703,327,334,833,1494,111703,0.21887550200803213,0.22356091030789826,0.5575635876840697,6
111704,359,371,846,1576,111704,0.22779187817258884,0.23540609137055837,0.5368020304568528,6
111800,320,499,349,1168,111800,0.273972602739726,0.4272260273972603,0.2988013698630137,4
111801,626,628,1587,2841,111801,0.22034494896163323,0.2210489264343541,0.5586061246040127,6
111802,315,309,800,1424,111802,0.22120786516853932,0.2169943820224719,0.5617977528089888,6
111803,310,249,691,1250,111803,0.248,0.1992,0.5528,6
111804,262,283,622,1167,111804,0.22450728363324765,0.24250214224507283,0.5329905741216795,6
111900,495,536,1431,2462,111900,0.20105605199025184,0.21770917952883834,0.5812347684809098,6
112000,357,610,366,1333,112000,0.2678169542385596,0.4576144036009002,0.2745686421605401,4
112001,454,556,1212,2222,112001,0.20432043204320433,0.2502250225022502,0.5454545454545454,6
112002,448,487,1277,2212,112002,0.20253164556962025,0.2201627486437613,0.5773056057866185,6
112102,327,311,982,1620,112102,0.20185185185185187,0.19197530864197532,0.6061728395061728,6
112103,409,438,1078,1925,112103,0.21246753246753247,0.22753246753246753,0.56,6
112104,212,201,639,1052,112104,0.20152091254752852,0.19106463878326996,0.6074144486692015,6
112200,349,498,349,1196,112200,0.29180602006688966,0.41638795986622074,0.29180602006688966,4
112204,348,364,1034,1746,112204,0.19931271477663232,0.20847651775486828,0.5922107674684994,6
112206,633,724,1947,3304,112206,0.1915859564164649,0.21912832929782083,0.5892857142857143,6
112210,598,699,1757,3054,112210,0.19580877537655533,0.2288801571709234,0.5753110674525213,6
112211,418,432,1205,2055,112211,0.20340632603406325,0.21021897810218979,0.5863746958637469,6
112212,279,259,894,1432,112212,0.19483240223463688,0.1808659217877095,0.6243016759776536,6
112213,429,510,1312,2251,112213,0.1905819635717459,0.22656597067969791,0.5828520657485562,6
112214,558,542,1482,2582,112214,0.2161115414407436,0.2099147947327653,0.5739736638264911,6
112300,153,214,408,775,112300,0.19741935483870968,0.2761290322580645,0.5264516129032258,6
112400,330,526,484,1340,112400,0.2462686567164179,0.3925373134328358,0.3611940298507463,5
112600,409,609,440,1458,112600,0.28052126200274347,0.4176954732510288,0.3017832647462277,5
112800,421,635,421,1477,112800,0.28503723764387273,0.4299255247122546,0.28503723764387273,4
112900,141,178,448,767,112900,0.18383311603650587,0.2320730117340287,0.5840938722294654,6
113000,395,669,540,1604,113000,0.24625935162094764,0.4170822942643391,0.33665835411471323,5
113200,236,351,331,918,113200,0.2570806100217865,0.38235294117647056,0.36056644880174293,5
113300,107,151,333,591,113300,0.18104906937394247,0.25549915397631134,0.5634517766497462,6
113400,292,475,233,1000,113400,0.292,0.475,0.233,4
113900,225,310,609,1144,113900,0.19667832167832167,0.270979020979021,0.5323426573426573,6
114100,219,239,550,1008,114100,0.21726190476190477,0.2371031746031746,0.5456349206349206,6
114201,154,258,233,645,114201,0.23875968992248062,0.4,0.3612403100775194,5
114202,259,448,366,1073,114202,0.2413793103448276,0.4175209692451072,0.34109972041006525,5
114400,327,457,261,1045,114400,0.3129186602870813,0.43732057416267944,0.24976076555023924,1
114600,335,499,340,1174,114600,0.28534923339011925,0.4250425894378194,0.28960817717206133,4
114700,162,211,396,769,114700,0.2106631989596879,0.2743823146944083,0.5149544863459038,6
115000,266,446,309,1021,115000,0.2605288932419197,0.43682664054848186,0.30264446620959845,5
115100,125,157,266,548,115100,0.2281021897810219,0.2864963503649635,0.4854014598540146,6
115200,305,442,371,1118,115200,0.27280858676207514,0.3953488372093023,0.33184257602862255,5
115500,179,238,363,780,115500,0.22948717948717948,0.30512820512820515,0.4653846153846154,5
115600,519,789,489,1797,115600,0.2888146911519199,0.43906510851419034,0.27212020033388984,4
115700,297,354,501,1152,115700,0.2578125,0.3072916666666667,0.4348958333333333,5
115800,360,539,420,1319,115800,0.27293404094010615,0.4086429112964367,0.31842304776345715,5
115900,346,413,494,1253,115900,0.2761372705506784,0.329608938547486,0.3942537909018356,5
116000,285,402,358,1045,116000,0.2727272727272727,0.384688995215311,0.34258373205741627,5
116100,377,480,499,1356,116100,0.278023598820059,0.35398230088495575,0.36799410029498525,5
116200,238,352,328,918,116200,0.25925925925925924,0.38344226579520696,0.3572984749455338,5
116300,715,814,750,2279,116300,0.3137340939008337,0.3571741992101799,0.3290917068889864,3
116400,265,442,398,1105,116400,0.2398190045248869,0.4,0.3601809954751131,5
116600,298,439,414,1151,116600,0.25890529973935705,0.3814074717636838,0.35968722849695917,5
116700,197,221,214,632,116700,0.31170886075949367,0.34968354430379744,0.33860759493670883,3
116800,228,338,232,798,116800,0.2857142857142857,0.42355889724310775,0.2907268170426065,4
117000,240,366,196,802,117000,0.29925187032418954,0.456359102244389,0.24438902743142144,4
117100,248,316,313,877,117100,0.28278221208665905,0.3603192702394527,0.35689851767388825,5
117201,268,494,337,1099,117201,0.24385805277525022,0.4494995450409463,0.30664240218380345,5
117202,376,652,449,1477,117202,0.25457007447528773,0.4414353419092756,0.3039945836154367,5
117400,468,731,448,1647,117400,0.28415300546448086,0.44383727990285365,0.27200971463266543,4
117500,364,476,720,1560,117500,0.23333333333333334,0.30512820512820515,0.46153846153846156,5
117601,266,472,305,1043,117601,0.2550335570469799,0.45254074784276127,0.29242569511025884,4
117602,364,570,395,1329,117602,0.27389014296463504,0.4288939051918736,0.29721595184349137,4
117800,189,325,224,738,117800,0.25609756097560976,0.44037940379403795,0.3035230352303523,5
118000,47,37,42,126,118000,0.373015873015873,0.29365079365079366,0.3333333333333333,2
118100,144,213,327,684,118100,0.21052631578947367,0.31140350877192985,0.4780701754385965,5
118201,293,546,353,1192,118201,0.24580536912751677,0.45805369127516776,0.2961409395973154,4
118202,251,484,362,1097,118202,0.22880583409298086,0.4412032816773017,0.3299908842297174,5
118400,467,812,517,1796,118400,0.26002227171492204,0.4521158129175947,0.2878619153674833,4
118500,187,195,209,591,118500,0.3164128595600677,0.3299492385786802,0.3536379018612521,3
118600,319,506,359,1184,118600,0.26942567567567566,0.42736486486486486,0.3032094594594595,5
118700,257,271,276,804,118700,0.31965174129353235,0.3370646766169154,0.34328358208955223,3
118800,472,788,433,1693,118800,0.27879503839338454,0.4654459539279386,0.25575900767867693,4
118900,257,272,327,856,118900,0.3002336448598131,0.3177570093457944,0.3820093457943925,3
119000,229,396,234,859,119000,0.26658905704307334,0.4610011641443539,0.2724097788125728,4
119100,281,314,359,954,119100,0.2945492662473795,0.32914046121593293,0.37631027253668764,5
119200,312,515,291,1118,119200,0.27906976744186046,0.4606440071556351,0.26028622540250446,4
119300,198,287,336,821,119300,0.24116930572472595,0.34957369062119364,0.4092570036540804,5
119400,371,599,470,1440,119400,0.25763888888888886,0.41597222222222224,0.3263888888888889,5
119500,178,175,298,651,119500,0.27342549923195086,0.26881720430107525,0.4577572964669739,6
119600,524,876,570,1970,119600,0.265989847715736,0.4446700507614213,0.2893401015228426,4
119800,348,504,374,1226,119800,0.2838499184339315,0.4110929853181077,0.30505709624796085,5
119900,154,193,261,608,119900,0.2532894736842105,0.31743421052631576,0.4292763157894737,5
120000,488,741,729,1958,120000,0.24923391215526047,0.37844739530132787,0.37231869254341166,5
120100,193,209,216,618,120100,0.3122977346278317,0.33818770226537215,0.34951456310679613,3
120200,224,352,217,793,120200,0.28247162673392184,0.44388398486759145,0.27364438839848676,4
120300,164,208,236,608,120300,0.26973684210526316,0.34210526315789475,0.3881578947368421,5
120500,326,296,314,936,120500,0.3482905982905983,0.3162393162393162,0.33547008547008544,3
120700,267,316,448,1031,120700,0.25897187196896215,0.3064985451018429,0.43452958292919497,5
120800,779,1411,967,3157,120800,0.24675324675324675,0.4469433006018372,0.30630345264491604,5
121000,460,682,305,1447,121000,0.3178991015894955,0.47131997235659984,0.21078092605390464,1
121100,34,68,38,140,121100,0.24285714285714285,0.4857142857142857,0.2714285714285714,4
121400,456,682,357,1495,121400,0.30501672240802674,0.4561872909698997,0.23879598662207357,1
121500,379,428,542,1349,121500,0.2809488510007413,0.3172720533728688,0.4017790956263899,5
122000,462,887,733,2082,122000,0.2219020172910663,0.4260326609029779,0.3520653218059558,5
122300,768,917,1537,3222,122300,0.2383612662942272,0.2846058348851645,0.47703289882060834,6
122403,248,431,486,1165,122403,0.2128755364806867,0.3699570815450644,0.4171673819742489,5
122404,444,557,857,1858,122404,0.23896663078579117,0.2997847147470398,0.461248654467169,6
122405,366,532,608,1506,122405,0.24302788844621515,0.35325365205843295,0.4037184594953519,5
122406,501,998,649,2148,122406,0.23324022346368714,0.46461824953445063,0.3021415270018622,5
122501,461,758,581,1800,122501,0.2561111111111111,0.4211111111111111,0.3227777777777778,5
122502,610,921,858,2389,122502,0.25533696107157805,0.3855169526998744,0.3591460862285475,5
122601,608,819,1261,2688,122601,0.2261904761904762,0.3046875,0.46912202380952384,5
122602,510,604,1011,2125,122602,0.24,0.2842352941176471,0.4757647058823529,6
122603,607,761,1381,2749,122603,0.22080756638777738,0.2768279374317934,0.5023644961804292,6
122701,729,1071,1803,3603,122701,0.20233139050791007,0.29725228975853457,0.5004163197335554,6
122702,617,837,831,2285,122702,0.2700218818380744,0.3663019693654267,0.3636761487964989,5
122704,252,362,410,1024,122704,0.24609375,0.353515625,0.400390625,5
122705,363,417,612,1392,122705,0.2607758620689655,0.2995689655172414,0.4396551724137931,6
122706,410,548,817,1775,122706,0.23098591549295774,0.3087323943661972,0.4602816901408451,5
122707,353,429,682,1464,122707,0.24112021857923496,0.2930327868852459,0.46584699453551914,6
122801,580,896,1044,2520,122801,0.23015873015873015,0.35555555555555557,0.4142857142857143,5
122802,537,746,1128,2411,122802,0.22272915802571547,0.309415180423061,0.46785566155122355,5
122901,748,802,1504,3054,122901,0.24492468893254749,0.26260641781270466,0.49246889325474785,6
122902,512,614,1121,2247,122902,0.22785936804628393,0.27325322652425454,0.49888740542946153,6
123001,635,859,1368,2862,123001,0.22187281621243884,0.3001397624039133,0.4779874213836478,5
123002,584,653,988,2225,123002,0.26247191011235954,0.2934831460674157,0.44404494382022475,6
123101,367,482,931,1780,123101,0.20617977528089887,0.27078651685393257,0.5230337078651686,6
123102,444,563,1074,2081,123102,0.21335896203748198,0.27054300816914945,0.5160980297933686,6
123201,282,468,396,1146,123201,0.24607329842931938,0.4083769633507853,0.34554973821989526,5
123202,983,1651,1281,3915,123202,0.2510855683269476,0.42171136653895275,0.32720306513409964,5
123301,936,1505,1292,3733,123301,0.25073667291722473,0.4031609965175462,0.34610233056522904,5
123302,219,481,348,1048,123302,0.20896946564885496,0.45896946564885494,0.3320610687022901,5
123401,467,687,797,1951,123401,0.23936442849820605,0.3521271143003588,0.40850845720143514,5
123402,878,1160,1601,3639,123402,0.2412750755702116,0.31876889255289914,0.43995603187688925,5
123500,586,867,1205,2658,123500,0.22046651617757712,0.3261851015801354,0.4533483822422874,5
123600,387,416,942,1745,123600,0.22177650429799428,0.23839541547277937,0.5398280802292263,6
123700,1025,632,544,2201,123700,0.46569741026806,0.28714220808723306,0.24716038164470694,0
123701,799,1551,1180,3530,123701,0.2263456090651558,0.43937677053824364,0.3342776203966006,5
123702,1331,1665,2379,5375,123702,0.2476279069767442,0.3097674418604651,0.4426046511627907,5
123801,685,757,1514,2956,123801,0.2317320703653586,0.2560893098782138,0.5121786197564276,6
123802,502,682,1221,2405,123802,0.20873180873180874,0.2835758835758836,0.5076923076923077,6
123900,600,784,1120,2504,123900,0.23961661341853036,0.31309904153354634,0.4472843450479233,5
124001,502,693,1107,2302,124001,0.21807124239791487,0.30104257167680276,0.4808861859252824,5
124002,386,482,817,1685,124002,0.229080118694362,0.286053412462908,0.48486646884273,6
124100,313,433,648,1394,124100,0.22453371592539456,0.31061692969870874,0.4648493543758967,5
124101,624,715,1115,2454,124101,0.254278728606357,0.291361043194784,0.454360228198859,6
124102,568,619,1215,2402,124102,0.23646960865945046,0.25770191507077433,0.5058284762697752,6
124200,986,1101,2070,4157,124200,0.23719028145297089,0.2648544623526582,0.4979552561943709,6
124300,959,1054,2189,4202,124300,0.2282246549262256,0.25083293669681106,0.5209424083769634,6
124401,536,579,1362,2477,124401,0.21639079531691563,0.23375050464271296,0.5498587000403714,6
124402,410,434,817,1661,124402,0.24683925346177002,0.26128838049367853,0.4918723660445515,6
124500,560,577,1291,2428,124500,0.23064250411861614,0.23764415156507412,0.5317133443163097,6
124601,288,322,749,1359,124601,0.2119205298013245,0.23693892568064753,0.551140544518028,6
124602,425,480,1125,2030,124602,0.20935960591133004,0.23645320197044334,0.5541871921182266,6
124700,335,399,685,1419,124700,0.23608174770965468,0.28118393234672306,0.48273431994362226,6
125700,333,396,562,1291,125700,0.2579395817195972,0.3067389620449264,0.43532145623547636,5
126500,188,243,328,759,126500,0.24769433465085638,0.3201581027667984,0.4321475625823452,5
126700,299,369,552,1220,126700,0.24508196721311476,0.30245901639344264,0.4524590163934426,5
127700,326,394,771,1491,127700,0.21864520456069753,0.2642521797451375,0.5171026156941649,6
128300,24,49,45,118,128300,0.2033898305084746,0.4152542372881356,0.3813559322033898,5
129102,242,300,685,1227,129102,0.19722901385493072,0.24449877750611246,0.5582722086389568,6
129103,261,315,715,1291,129103,0.2021688613477924,0.243996901626646,0.5538342370255616,6
129104,312,356,914,1582,129104,0.1972187104930468,0.225031605562579,0.5777496839443742,6
130003,662,706,1171,2539,130003,0.2607325718786924,0.27806222922410395,0.4612051988972036,6
130004,222,256,425,903,130004,0.24584717607973422,0.28349944629014395,0.4706533776301218,6
130005,326,331,641,1298,130005,0.25115562403698,0.25500770416024654,0.4938366718027735,6
130100,266,432,812,1510,130100,0.176158940397351,0.2860927152317881,0.5377483443708609,6
133300,351,408,740,1499,133300,0.2341561040693796,0.27218145430286855,0.49366244162775186,6
133900,145,154,319,618,133900,0.23462783171521034,0.24919093851132687,0.5161812297734628,6
134100,348,402,662,1412,134100,0.24645892351274787,0.2847025495750708,0.4688385269121813,6
134700,788,957,1538,3283,134700,0.24002436795613769,0.29150167529698445,0.46847395674687786,6
134702,654,684,1588,2926,134702,0.22351332877648666,0.23376623376623376,0.5427204374572796,6
134703,323,365,981,1669,134703,0.19352905931695627,0.21869382863990414,0.5877771120431396,6
134704,235,247,670,1152,134704,0.20399305555555555,0.2144097222222222,0.5815972222222222,6
134902,478,419,1342,2239,134902,0.21348816435908888,0.18713711478338543,0.5993747208575256,6
134903,141,112,371,624,134903,0.22596153846153846,0.1794871794871795,0.594551282051282,6
134904,618,641,1698,2957,134904,0.20899560365235034,0.2167737571863375,0.5742306391613121,6
134906,517,538,1397,2452,134906,0.21084828711256118,0.21941272430668843,0.5697389885807504,6
134907,360,442,1060,1862,134907,0.1933404940923738,0.23737916219119226,0.569280343716434,6
135002,578,547,1452,2577,135002,0.2242918121847109,0.21226232052774544,0.5634458672875436,6
135003,524,438,1279,2241,135003,0.23382418563141455,0.19544846050870146,0.5707273538598839,6
135004,289,343,971,1603,135004,0.1802869619463506,0.21397379912663755,0.6057392389270119,6
135005,340,336,839,1515,135005,0.22442244224422442,0.22178217821782178,0.5537953795379538,6
135101,486,475,1273,2234,135101,0.21754700089525514,0.2126230975828111,0.5698299015219338,6
135102,570,538,1447,2555,135102,0.22309197651663404,0.21056751467710372,0.5663405088062622,6
135103,658,622,1663,2943,135103,0.2235813795446823,0.21134896364254163,0.5650696568127761,6
135104,651,587,1724,2962,135104,0.2197839297771776,0.19817690749493586,0.5820391627278866,6
135201,319,311,735,1365,135201,0.2336996336996337,0.22783882783882783,0.5384615384615384,6
135204,555,526,1449,2530,135204,0.21936758893280633,0.20790513833992094,0.5727272727272728,6
135205,672,599,1662,2933,135205,0.22911694510739858,0.20422775315376748,0.5666553017388339,6
135208,422,368,944,1734,135208,0.2433679354094579,0.2122260668973472,0.544405997693195,6
135209,322,343,889,1554,135209,0.2072072072072072,0.22072072072072071,0.5720720720720721,6
135301,371,393,1064,1828,135301,0.20295404814004375,0.2149890590809628,0.5820568927789934,6
135303,443,441,1136,2020,135303,0.2193069306930693,0.21831683168316832,0.5623762376237624,6
135304,365,311,910,1586,135304,0.23013871374527112,0.1960907944514502,0.5737704918032787,6
135401,631,599,1684,2914,135401,0.21654083733699384,0.20555936856554563,0.5778997940974605,6
135402,695,699,1856,3250,135402,0.21384615384615385,0.21507692307692308,0.571076923076923,6
135403,407,510,1221,2138,135403,0.1903648269410664,0.23854069223573432,0.5710944808231992,6
136700,419,535,1034,1988,136700,0.2107645875251509,0.26911468812877265,0.5201207243460765,6
137700,475,641,1053,2169,137700,0.218994928538497,0.2955278930382665,0.4854771784232365,6
138501,343,498,752,1593,138501,0.21531701192718142,0.3126177024482109,0.47206528562460764,5
138502,23,42,29,94,138502,0.24468085106382978,0.44680851063829785,0.30851063829787234,5
139900,132,213,335,680,139900,0.19411764705882353,0.31323529411764706,0.49264705882352944,5
140101,434,518,776,1728,140101,0.2511574074074074,0.29976851851851855,0.44907407407407407,6
140200,826,1006,1875,3707,140200,0.22282168869705962,0.2713784731588886,0.5057998381440518,6
140300,1055,1238,2097,4390,140300,0.24031890660592256,0.282004555808656,0.4776765375854214,6
140400,770,648,1766,3184,140400,0.24183417085427136,0.20351758793969849,0.5546482412060302,6
140500,348,421,822,1591,140500,0.21873035826524198,0.2646134506599623,0.5166561910747958,6
140602,469,491,922,1882,140602,0.24920297555791712,0.26089266737513284,0.48990435706695007,6
140700,909,946,2016,3871,140700,0.23482304314130717,0.2443812968225265,0.5207956600361664,6
140801,433,440,794,1667,140801,0.259748050389922,0.26394721055788845,0.47630473905218956,6
140901,93,128,148,369,140901,0.25203252032520324,0.34688346883468835,0.4010840108401084,5
140902,221,283,462,966,140902,0.2287784679089027,0.29296066252587993,0.4782608695652174,6
141700,432,496,805,1733,141700,0.24927870744373917,0.28620888632429314,0.4645124062319677,6
142900,385,482,657,1524,142900,0.2526246719160105,0.31627296587926507,0.4311023622047244,5
143500,252,268,406,926,143500,0.27213822894168466,0.2894168466522678,0.43844492440604754,6
144100,307,361,599,1267,144100,0.24230465666929754,0.2849250197316496,0.47277032359905286,6
144700,364,331,525,1220,144700,0.2983606557377049,0.2713114754098361,0.430327868852459,6
145101,166,184,265,615,145101,0.26991869918699185,0.2991869918699187,0.43089430894308944,6
145102,278,275,433,986,145102,0.281947261663286,0.2789046653144016,0.43914807302231235,6
145602,625,1267,816,2708,145602,0.23079763663220088,0.4678729689807976,0.30132939438700146,5
145603,682,1311,805,2798,145603,0.2437455325232309,0.46854896354538955,0.28770550393137956,4
145604,550,1089,672,2311,145604,0.23799221116399827,0.4712245781047166,0.29078321073128516,4
145605,487,872,569,1928,145605,0.2525933609958506,0.45228215767634855,0.29512448132780084,4
145701,907,913,2032,3852,145701,0.2354620976116303,0.2370197300103842,0.5275181723779855,6
145702,770,1411,963,3144,145702,0.24491094147582698,0.4487913486005089,0.3062977099236641,5
145703,614,1320,906,2840,145703,0.21619718309859154,0.4647887323943662,0.3190140845070423,5
145704,868,1434,1498,3800,145704,0.22842105263157894,0.3773684210526316,0.39421052631578946,5
145803,673,693,1563,2929,145803,0.2297712529873677,0.23659952202116763,0.5336292249914647,6
145804,606,775,1221,2602,145804,0.2328977709454266,0.297847809377402,0.4692544196771714,6
145805,770,852,1762,3384,145805,0.22754137115839243,0.25177304964539005,0.5206855791962175,6
145807,648,734,1438,2820,145807,0.2297872340425532,0.2602836879432624,0.5099290780141844,6
145808,476,534,992,2002,145808,0.23776223776223776,0.26673326673326675,0.4955044955044955,6
145900,271,284,601,1156,145900,0.23442906574394465,0.24567474048442905,0.5198961937716263,6
145901,549,833,1105,2487,145901,0.22074788902291917,0.3349416968234821,0.44431041415359873,5
145902,1013,1786,1437,4236,145902,0.23914069877242683,0.42162417374881966,0.33923512747875356,5
145903,594,766,1245,2605,145903,0.22802303262955853,0.2940499040307102,0.4779270633397313,6
146001,546,1095,596,2237,146001,0.2440768886902101,0.4894948591864104,0.2664282521233795,4
146002,604,1155,738,2497,146002,0.24189026832198637,0.46255506607929514,0.29555466559871846,4
146003,855,1238,1388,3481,146003,0.24561907497845448,0.3556449296179259,0.39873599540361965,5
146102,293,602,359,1254,146102,0.23365231259968103,0.4800637958532695,0.2862838915470494,4
146103,481,528,982,1991,146103,0.2415871421396283,0.26519337016574585,0.4932194876946258,6
146105,675,1384,790,2849,146105,0.23692523692523693,0.4857844857844858,0.2772902772902773,4
146106,495,921,589,2005,146106,0.24688279301745636,0.45935162094763093,0.2937655860349127,4
146201,484,993,630,2107,146201,0.22971048884670148,0.4712861888941623,0.29900332225913623,4
146202,496,979,594,2069,146202,0.23972933784436926,0.47317544707588205,0.28709521507974867,4
146203,579,982,727,2288,146203,0.2530594405594406,0.4291958041958042,0.31774475524475526,5
146204,610,1276,760,2646,146204,0.23053665910808768,0.48223733938019653,0.2872260015117158,4
146205,236,303,619,1158,146205,0.20379965457685664,0.2616580310880829,0.5345423143350605,6
146206,201,381,560,1142,146206,0.17600700525394045,0.3336252189141856,0.4903677758318739,5
146300,434,553,974,1961,146300,0.22131565527791944,0.28199898011218766,0.49668536460989293,6
146402,495,577,821,1893,146402,0.26148969889064977,0.3048071843634443,0.43370311674590595,5
146403,457,946,680,2083,146403,0.21939510321651465,0.4541526644263082,0.32645223235717713,5
146404,394,669,547,1610,146404,0.24472049689440994,0.415527950310559,0.33975155279503105,5
146500,601,773,1311,2685,146500,0.22383612662942273,0.28789571694599625,0.488268156424581,6
146604,651,803,1625,3079,146604,0.21143228320883403,0.26079896070152647,0.5277687560896395,6
146605,130,151,320,601,146605,0.21630615640599002,0.2512479201331115,0.5324459234608985,6
146606,683,839,1864,3386,146606,0.20171293561724749,0.24778499704666274,0.5505020673360898,6
146607,263,386,652,1301,146607,0.202152190622598,0.29669485011529595,0.5011529592621061,6
146608,272,332,661,1265,146608,0.2150197628458498,0.2624505928853755,0.5225296442687747,6
146611,313,400,839,1552,146611,0.20167525773195877,0.25773195876288657,0.5405927835051546,6
146612,560,660,1287,2507,146612,0.22337455125648184,0.26326286398085363,0.5133625847626645,6
146613,405,482,958,1845,146613,0.21951219512195122,0.2612466124661247,0.5192411924119241,6
146614,595,667,1600,2862,146614,0.20789657582110413,0.23305380852550664,0.5590496156533893,6
146615,465,625,1355,2445,146615,0.1901840490797546,0.2556237218813906,0.5541922290388548,6
146700,203,245,512,960,146700,0.21145833333333333,0.2552083333333333,0.5333333333333333,6
146703,412,733,691,1836,146703,0.22440087145969498,0.39923747276688454,0.37636165577342046,5
146704,264,277,484,1025,146704,0.2575609756097561,0.2702439024390244,0.4721951219512195,6
146705,315,430,872,1617,146705,0.19480519480519481,0.2659245516388373,0.5392702535559678,6
146706,345,384,682,1411,146706,0.2445074415308292,0.2721474131821403,0.4833451452870305,6
146800,687,725,1465,2877,146800,0.23879040667361837,0.25199860966284326,0.5092109836635385,6
146901,763,803,1939,3505,146901,0.21768901569186877,0.22910128388017117,0.55320970042796,6
146902,618,559,1465,2642,146902,0.23391370174110523,0.21158213474640425,0.5545041635124905,6
147001,695,733,1511,2939,147001,0.23647499149370535,0.2494045593739367,0.514120449132358,6
147003,647,674,1606,2927,147003,0.2210454390160574,0.2302699009224462,0.5486846600614964,6
147004,49,96,154,299,147004,0.16387959866220736,0.3210702341137124,0.5150501672240803,5
147100,633,710,1595,2938,147100,0.21545268890401634,0.24166099387338325,0.5428863172226004,6
147200,696,894,1327,2917,147200,0.2386013027082619,0.3064792595131985,0.4549194377785396,5
147300,655,1049,1242,2946,147300,0.22233536999321113,0.3560760353021045,0.4215885947046843,5
147401,614,882,1501,2997,147401,0.20487153820487153,0.29429429429429427,0.5008341675008342,6
147402,425,422,985,1832,147402,0.23198689956331878,0.23034934497816595,0.5376637554585153,6
147501,774,883,1895,3552,147501,0.2179054054054054,0.24859234234234234,0.5335022522522522,6
147502,775,763,1686,3224,147502,0.2403846153846154,0.23666253101736973,0.5229528535980149,6
147503,227,242,597,1066,147503,0.2129455909943715,0.2270168855534709,0.5600375234521576,6
147601,252,237,700,1189,147601,0.21194280908326324,0.19932716568544995,0.5887300252312868,6
147602,531,562,1276,2369,147602,0.2241452089489236,0.23723089911355003,0.5386238919375264,6
147701,357,441,862,1660,147701,0.21506024096385543,0.2656626506024096,0.519277108433735,6
147702,534,526,1195,2255,147702,0.23680709534368072,0.23325942350332593,0.5299334811529933,6
147802,426,336,1022,1784,147802,0.23878923766816143,0.18834080717488788,0.5728699551569507,6
147803,340,378,733,1451,147803,0.2343211578221916,0.2605099931082012,0.5051688490696071,6
147804,580,629,1568,2777,147804,0.20885848037450486,0.2265034209578682,0.5646380986676269,6
147900,292,403,802,1497,147900,0.19505678022712092,0.26920507682030725,0.5357381429525718,6
147901,436,523,1176,2135,147901,0.20421545667447308,0.2449648711943794,0.5508196721311476,6
147902,427,487,1191,2105,147902,0.20285035629453682,0.23135391923990498,0.5657957244655581,6
148300,217,271,531,1019,148300,0.2129538763493621,0.26594700686947986,0.521099116781158,6
150003,287,245,460,992,150003,0.28931451612903225,0.2469758064516129,0.4637096774193548,6
150004,408,440,832,1680,150004,0.24285714285714285,0.2619047619047619,0.49523809523809526,6
150005,287,311,628,1226,150005,0.23409461663947798,0.2536704730831974,0.5122349102773246,6
150006,210,260,439,909,150006,0.23102310231023102,0.28602860286028603,0.4829482948294829,6
150100,622,663,588,1873,150100,0.33208756006406837,0.3539775760811532,0.3139348638547784,3
150200,829,1048,1310,3187,150200,0.2601192343897082,0.32883589582679634,0.41104486978349547,5
150300,559,688,561,1808,150300,0.30918141592920356,0.3805309734513274,0.310287610619469,3
150400,419,381,440,1240,150400,0.3379032258064516,0.307258064516129,0.3548387096774194,3
150500,465,556,456,1477,150500,0.3148273527420447,0.3764387271496276,0.3087339201083277,3
150701,201,257,504,962,150701,0.20893970893970895,0.26715176715176714,0.5239085239085239,6
150702,225,270,606,1101,150702,0.20435967302452315,0.2452316076294278,0.5504087193460491,6
152200,323,465,780,1568,152200,0.2059948979591837,0.2965561224489796,0.49744897959183676,6
152901,401,528,1121,2050,152901,0.19560975609756098,0.2575609756097561,0.546829268292683,6
152902,321,497,945,1763,152902,0.1820760068065797,0.2819058423142371,0.5360181508791833,6
155101,128,185,320,633,155101,0.20221169036334913,0.292259083728278,0.5055292259083728,6
155102,560,797,1593,2950,155102,0.18983050847457628,0.27016949152542374,0.54,6
156700,97,155,241,493,156700,0.19675456389452334,0.3144016227180527,0.48884381338742394,5
157101,622,735,1371,2728,157101,0.2280058651026393,0.2694281524926686,0.5025659824046921,6
157102,180,255,308,743,157102,0.24226110363391656,0.34320323014804843,0.414535666218035,5
157901,408,508,966,1882,157901,0.21679064824654623,0.26992561105207225,0.5132837407013815,6
157902,326,472,680,1478,157902,0.22056833558863329,0.3193504736129905,0.46008119079837617,5
157903,411,497,873,1781,157903,0.23076923076923078,0.27905670971364405,0.4901740595171252,6
158001,325,372,1172,1869,158001,0.17388978063135366,0.19903691813804172,0.6270733012306046,6
158002,461,515,1545,2521,158002,0.1828639428798096,0.2042840142800476,0.6128520428401428,6
158006,587,600,1598,2785,158006,0.21077199281867146,0.21543985637342908,0.5737881508078995,6
158007,323,407,792,1522,158007,0.21222076215505914,0.26741130091984233,0.5203679369250985,6
158009,269,239,678,1186,158009,0.22681281618887014,0.2015177065767285,0.5716694772344013,6
158010,355,338,977,1670,158010,0.2125748502994012,0.20239520958083831,0.5850299401197605,6
158011,366,419,1089,1874,158011,0.19530416221985059,0.22358591248665954,0.5811099252934898,6
158102,555,772,1213,2540,158102,0.21850393700787402,0.30393700787401573,0.47755905511811025,5
158103,517,608,997,2122,158103,0.24363807728557965,0.2865221489161169,0.4698397737983035,6
158104,688,772,1330,2790,158104,0.24659498207885305,0.27670250896057347,0.4767025089605735,6
158107,415,553,918,1886,158107,0.2200424178154825,0.2932131495227996,0.4867444326617179,6
158108,257,337,725,1319,158108,0.19484457922668688,0.25549658832448824,0.5496588324488249,6
158110,421,524,877,1822,158110,0.2310647639956092,0.287596048298573,0.4813391877058178,6
158111,419,506,810,1735,158111,0.2414985590778098,0.29164265129683,0.4668587896253602,6
158112,511,670,922,2103,158112,0.24298621017593913,0.3185924869234427,0.43842130290061815,5
158114,407,473,905,1785,158114,0.2280112044817927,0.2649859943977591,0.5070028011204482,6
158115,658,839,1483,2980,158115,0.22080536912751678,0.2815436241610738,0.4976510067114094,6
158116,242,264,519,1025,158116,0.23609756097560974,0.2575609756097561,0.5063414634146342,6
158202,770,847,1595,3212,158202,0.23972602739726026,0.2636986301369863,0.4965753424657534,6
158203,162,176,444,782,158203,0.2071611253196931,0.22506393861892582,0.5677749360613811,6
158205,177,194,483,854,158205,0.20725995316159251,0.22716627634660422,0.5655737704918032,6
158206,306,381,835,1522,158206,0.20105124835742444,0.2503285151116951,0.5486202365308804,6
158207,412,457,1147,2016,158207,0.20436507936507936,0.22668650793650794,0.5689484126984127,6
158304,696,630,1766,3092,158304,0.22509702457956016,0.203751617076326,0.5711513583441138,6
158306,624,629,1395,2648,158306,0.23564954682779457,0.23753776435045318,0.5268126888217523,6
158308,888,1135,1880,3903,158308,0.2275172943889316,0.2908019472200871,0.4816807583909813,6
158309,487,606,973,2066,158309,0.2357212003872217,0.2933204259438529,0.47095837366892546,6
158310,375,505,820,1700,158310,0.22058823529411764,0.29705882352941176,0.4823529411764706,6
158315,483,642,1165,2290,158315,0.2109170305676856,0.28034934497816594,0.5087336244541485,6
158317,522,633,1351,2506,158317,0.2083000798084597,0.2525937749401437,0.5391061452513967,6
158318,482,550,1120,2152,158318,0.22397769516728624,0.2555762081784387,0.5204460966542751,6
158319,391,431,865,1687,158319,0.23177237700059278,0.2554831061055127,0.5127445168938944,6
158320,706,773,1494,2973,158320,0.23747056844937772,0.2600067272115708,0.5025227043390514,6
158321,892,1173,2150,4215,158321,0.21162514827995255,0.2782918149466192,0.5100830367734283,6
158322,188,184,459,831,158322,0.22623345367027678,0.2214199759326113,0.5523465703971119,6
158323,839,862,2000,3701,158323,0.2266954877060254,0.23291002431775196,0.5403944879762227,6
158401,186,166,435,787,158401,0.2363405336721728,0.21092757306226176,0.5527318932655655,6
158402,616,572,1560,2748,158402,0.22416302765647744,0.2081513828238719,0.5676855895196506,6
158403,235,286,573,1094,158403,0.21480804387568556,0.26142595978062155,0.5237659963436929,6
158405,712,700,1695,3107,158405,0.2291599613775346,0.2252977148374638,0.5455423237850016,6
158407,818,897,1854,3569,158407,0.2291958531801625,0.2513309050154105,0.519473241804427,6
158408,575,620,1277,2472,158408,0.2326051779935275,0.25080906148867316,0.5165857605177994,6
158409,493,597,1124,2214,158409,0.22267389340560073,0.2696476964769648,0.5076784101174345,6
158410,365,311,763,1439,158410,0.25364836692147325,0.21612230715774844,0.5302293259207783,6
158502,380,417,773,1570,158502,0.24203821656050956,0.26560509554140127,0.4923566878980892,6
158505,469,542,1012,2023,158505,0.23183391003460208,0.2679189322787939,0.5002471576866041,6
158506,336,391,653,1380,158506,0.24347826086956523,0.2833333333333333,0.4731884057971015,6
158507,513,546,903,1962,158507,0.26146788990825687,0.2782874617737003,0.4602446483180428,6
158508,697,808,1458,2963,158508,0.2352345595680054,0.27269659129260887,0.49206884913938576,6
158509,519,638,1155,2312,158509,0.22448096885813149,0.2759515570934256,0.4995674740484429,6
158510,805,974,1617,3396,158510,0.23704358068315665,0.2868080094228504,0.47614840989399293,6
158511,687,818,1539,3044,158511,0.22568988173455978,0.26872536136662284,0.5055847568988173,6
158512,444,490,972,1906,158512,0.23294858342077648,0.2570828961175236,0.5099685204616999,6
158604,735,820,1429,2984,158604,0.246313672922252,0.27479892761394104,0.478887399463807,6
158605,725,771,1434,2930,158605,0.24744027303754265,0.26313993174061434,0.489419795221843,6
158606,668,862,1374,2904,158606,0.23002754820936638,0.296831955922865,0.4731404958677686,6
158607,349,452,849,1650,158607,0.21151515151515152,0.2739393939393939,0.5145454545454545,6
158608,553,666,1009,2228,158608,0.24820466786355475,0.2989228007181329,0.4528725314183124,6
158609,632,771,1246,2649,158609,0.23858059645149113,0.29105322763306907,0.4703661759154398,6
158704,791,1057,1635,3483,158704,0.22710307206431238,0.3034740166523112,0.4694229112833764,5
158705,403,557,691,1651,158705,0.2440944881889764,0.33737129012719563,0.418534221683828,5
158707,182,251,434,867,158707,0.209919261822376,0.2895040369088812,0.5005767012687428,6
158708,389,558,892,1839,158708,0.2115280043501903,0.3034257748776509,0.4850462207721588,5
158709,212,307,560,1079,158709,0.19647822057460612,0.2845227062094532,0.5189990732159406,6
158710,389,484,882,1755,158710,0.22165242165242166,0.2757834757834758,0.5025641025641026,6
158711,509,685,1144,2338,158711,0.21770744225834046,0.29298545765611633,0.4893071000855432,6
158712,802,1134,1672,3608,158712,0.2222838137472284,0.3143015521064302,0.4634146341463415,5
158802,528,548,1253,2329,158802,0.22670674109059682,0.23529411764705882,0.5379991412623444,6
158803,761,843,1569,3173,158803,0.2398361172392058,0.2656791679798298,0.4944847147809644,6
158804,951,1154,1882,3987,158804,0.23852520692249812,0.2894406822172059,0.47203411086029595,6
158900,889,1156,1743,3788,158900,0.234688489968321,0.3051742344244984,0.4601372756071806,5
159000,664,796,1174,2634,159000,0.25208807896735,0.30220197418375094,0.44570994684889903,5
159102,820,1009,1624,3453,159102,0.23747465971618884,0.29220967274833476,0.4703156675354764,6
159103,582,912,945,2439,159103,0.23862238622386223,0.37392373923739236,0.3874538745387454,5
159105,734,1115,1577,3426,159105,0.21424401634559254,0.3254524226503211,0.4603035610040864,5
159106,615,934,1390,2939,159106,0.2092548485879551,0.31779516842463423,0.4729499829874107,5
159107,441,497,884,1822,159107,0.2420417124039517,0.27277716794731066,0.48518111964873767,6
159108,764,1034,1645,3443,159108,0.22189950624455418,0.3003194888178914,0.47778100493755443,5
159201,271,408,663,1342,159201,0.20193740685543965,0.30402384500745155,0.4940387481371088,5
159203,530,721,1308,2559,159203,0.20711215318483783,0.28175068386088314,0.511137162954279,6
159204,442,639,977,2058,159204,0.21477162293488825,0.3104956268221574,0.4747327502429543,5
159300,275,280,589,1144,159300,0.2403846153846154,0.24475524475524477,0.5148601398601399,6
159404,936,1263,1578,3777,159404,0.24781572676727562,0.33439237490071483,0.4177918983320095,5
159406,559,618,1059,2236,159406,0.25,0.276386404293381,0.473613595706619,6
159407,862,1164,1552,3578,159407,0.24091671324762437,0.325321408608161,0.43376187814421463,5
159408,590,828,1028,2446,159408,0.24121013900245297,0.3385118560915781,0.42027800490596895,5
159410,883,916,2090,3889,159410,0.22705065569555155,0.23553612753921316,0.5374132167652352,6
159411,333,489,767,1589,159411,0.20956576463184393,0.3077407174323474,0.48269351793580867,5
159412,711,858,1854,3423,159412,0.2077125328659071,0.2506573181419807,0.5416301489921121,6
159505,768,1140,1726,3634,159505,0.21133736929003852,0.31370390753990096,0.47495872317006055,5
159506,875,1333,1565,3773,159506,0.23191094619666047,0.3532997614630268,0.41478929234031275,5
159508,767,1012,1319,3098,159508,0.24757908327953518,0.32666236281471916,0.42575855390574563,5
159509,309,441,565,1315,159509,0.2349809885931559,0.33536121673003805,0.4296577946768061,5
159510,40,62,81,183,159510,0.2185792349726776,0.33879781420765026,0.4426229508196721,5
159511,640,1019,1199,2858,159511,0.22393282015395383,0.35654303708887336,0.41952414275717287,5
159512,237,367,491,1095,159512,0.21643835616438356,0.33515981735159817,0.4484018264840183,5
159601,573,690,1593,2856,159601,0.20063025210084034,0.2415966386554622,0.5577731092436975,6
159602,379,534,1082,1995,159602,0.1899749373433584,0.26766917293233083,0.5423558897243108,6
160003,218,289,441,948,160003,0.229957805907173,0.3048523206751055,0.4651898734177215,5
160004,200,222,538,960,160004,0.20833333333333334,0.23125,0.5604166666666667,6
160005,209,238,551,998,160005,0.2094188376753507,0.23847695390781562,0.5521042084168337,6
161700,357,570,863,1790,161700,0.19944134078212292,0.31843575418994413,0.482122905027933,5
162100,469,678,1050,2197,162100,0.21347291761492945,0.3086026399635867,0.47792444242148385,5
169701,978,1068,2116,4162,169701,0.23498318116290245,0.2566074002883229,0.5084094185487746,6
169703,224,297,538,1059,169703,0.21152030217186024,0.2804532577903683,0.5080264400377715,6
169704,861,1088,1647,3596,169704,0.23943270300333705,0.3025583982202447,0.45800889877641826,5
169800,712,1107,1255,3074,169800,0.23162003903708522,0.3601171112556929,0.4082628497072219,5
169901,626,857,1192,2675,169901,0.23401869158878505,0.32037383177570095,0.44560747663551403,5
169902,561,588,1000,2149,169902,0.2610516519311308,0.2736156351791531,0.46533271288971617,6
170000,411,488,750,1649,170000,0.24924196482716798,0.2959369314736204,0.45482110369921164,6
170001,639,813,1359,2811,170001,0.22732123799359658,0.2892209178228389,0.4834578441835646,6
170002,473,594,906,1973,170002,0.2397364419665484,0.30106436898124683,0.45919918905220475,5
170101,239,368,365,972,170101,0.24588477366255143,0.3786008230452675,0.37551440329218105,5
170201,635,799,1232,2666,170201,0.23818454613653414,0.2996999249812453,0.46211552888222057,6
170202,409,581,848,1838,170202,0.22252448313384113,0.31610446137105547,0.4613710554951034,5
180001,488,526,981,1995,180001,0.24461152882205514,0.2636591478696742,0.4917293233082707,6
180300,557,737,1126,2420,180300,0.23016528925619834,0.30454545454545456,0.4652892561983471,5
190101,548,588,1158,2294,190101,0.23888404533565824,0.2563208369659983,0.5047951176983435,6
190102,275,297,531,1103,190102,0.24932003626473254,0.2692656391659112,0.4814143245693563,6
190203,355,397,733,1485,190203,0.23905723905723905,0.2673400673400673,0.4936026936026936,6
190204,814,826,1394,3034,190204,0.2682926829268293,0.2722478576137113,0.4594594594594595,6
190301,518,553,989,2060,190301,0.25145631067961166,0.2684466019417476,0.48009708737864076,6
190401,963,1415,1881,4259,190401,0.2261094153557173,0.3322376144634891,0.44165297018079364,5
190402,741,854,1449,3044,190402,0.24342969776609724,0.28055190538764785,0.4760183968462549,6
190403,328,482,697,1507,190403,0.21765096217650962,0.31984074319840744,0.46250829462508297,5
190502,235,277,548,1060,190502,0.22169811320754718,0.26132075471698113,0.5169811320754717,6
190503,234,317,582,1133,190503,0.20653133274492497,0.2797881729920565,0.5136804942630185,6
190504,208,187,441,836,190504,0.24880382775119617,0.2236842105263158,0.527511961722488,6
190601,488,512,1065,2065,190601,0.23631961259079903,0.24794188861985472,0.5157384987893463,6
190603,414,530,838,1782,190603,0.23232323232323232,0.29741863075196406,0.4702581369248036,6
190604,430,585,950,1965,190604,0.21882951653944022,0.29770992366412213,0.48346055979643765,6
190704,211,314,474,999,190704,0.21121121121121122,0.31431431431431434,0.4744744744744745,5
190705,288,466,717,1471,190705,0.19578518014955812,0.3167912984364378,0.4874235214140041,5
190706,420,577,986,1983,190706,0.2118003025718608,0.2909732728189612,0.497226424609178,6
190707,403,571,1054,2028,190707,0.1987179487179487,0.28155818540433925,0.519723865877712,6
190708,216,232,371,819,190708,0.26373626373626374,0.28327228327228327,0.452991452991453,6
190800,250,390,554,1194,190800,0.20938023450586266,0.32663316582914576,0.4639865996649916,5
200001,262,439,713,1414,200001,0.18528995756718528,0.3104667609618105,0.5042432814710043,5
200002,200,256,362,818,200002,0.24449877750611246,0.31295843520782396,0.44254278728606355,5
200901,103,147,274,524,200901,0.1965648854961832,0.28053435114503816,0.5229007633587787,6
200902,655,900,1492,3047,200902,0.21496553987528716,0.29537249753856254,0.4896619625861503,6
201001,571,852,1280,2703,201001,0.21124676285608582,0.31520532741398444,0.4735479097299297,5
201003,365,568,786,1719,201003,0.2123327515997673,0.33042466550319954,0.4572425828970332,5
201004,392,584,683,1659,201004,0.23628691983122363,0.35201928872814947,0.4116937914406269,5
201100,642,1248,788,2678,201100,0.239731142643764,0.46601941747572817,0.29424943988050783,4
210101,767,831,1262,2860,210101,0.2681818181818182,0.29055944055944055,0.44125874125874126,6
210201,419,547,789,1755,210201,0.23874643874643875,0.31168091168091167,0.4495726495726496,5
210301,360,505,720,1585,210301,0.22712933753943218,0.3186119873817035,0.45425867507886436,5
220100,454,595,639,1688,220100,0.26895734597156395,0.3524881516587678,0.37855450236966826,5
220201,326,478,472,1276,220201,0.2554858934169279,0.37460815047021945,0.36990595611285265,5
220300,416,612,480,1508,220300,0.27586206896551724,0.40583554376657827,0.3183023872679045,5
220700,200,356,346,902,220700,0.22172949002217296,0.3946784922394678,0.3835920177383592,5
220801,336,391,617,1344,220801,0.25,0.29092261904761907,0.45907738095238093,6
220901,391,466,649,1506,220901,0.2596281540504648,0.3094289508632138,0.4309428950863214,5
221001,360,424,947,1731,221001,0.20797227036395147,0.24494511842865396,0.5470826112073945,6
221100,303,400,333,1036,221100,0.2924710424710425,0.3861003861003861,0.32142857142857145,5
300000,459,565,791,1815,300000,0.2528925619834711,0.31129476584022037,0.43581267217630854,5
300100,387,423,1141,1951,300100,0.19835981547924142,0.2168118913377755,0.5848282931829831,6
300300,518,494,1017,2029,300300,0.25529817644159686,0.24346968950221784,0.5012321340561853,6
300400,509,546,1371,2426,300400,0.20981038746908492,0.22506183017312448,0.5651277823577906,6
300500,464,454,1438,2356,300500,0.1969439728353141,0.1926994906621392,0.6103565365025467,6
300600,580,553,1738,2871,300600,0.20202020202020202,0.19261581330546848,0.6053639846743295,6
300700,464,539,1571,2574,300700,0.18026418026418026,0.2094017094017094,0.6103341103341103,6
300800,334,414,1165,1913,300800,0.174594877156299,0.21641400940930475,0.6089911134343963,6
300900,590,664,2075,3329,300900,0.1772303995193752,0.19945929708621207,0.6233103033944127,6
301000,320,328,1319,1967,301000,0.1626842907981698,0.16675139806812406,0.6705643111337062,6
301101,543,752,1599,2894,301101,0.1876295784381479,0.2598479612992398,0.5525224602626123,6
301102,348,348,1164,1860,301102,0.1870967741935484,0.1870967741935484,0.6258064516129033,6
301200,438,504,1461,2403,301200,0.1822721598002497,0.20973782771535582,0.6079900124843945,6
301300,431,536,1178,2145,301300,0.20093240093240095,0.24988344988344988,0.5491841491841492,6
301400,188,177,624,989,301400,0.19009100101112233,0.1789686552072801,0.6309403437815976,6
301500,198,218,815,1231,301500,0.16084484159220147,0.17709179528838342,0.6620633631194152,6
301600,303,316,1218,1837,301600,0.16494284158954817,0.17201959716929777,0.6630375612411541,6
301700,184,162,716,1062,301700,0.17325800376647835,0.15254237288135594,0.6741996233521658,6
301800,425,601,1311,2337,301800,0.181857081728712,0.25716730851519043,0.5609756097560976,6
301900,222,225,800,1247,301900,0.17802726543704891,0.18043303929430635,0.6415396952686447,6
302000,402,435,1336,2173,302000,0.18499769903359412,0.20018407731247123,0.6148182236539347,6
302101,300,363,1106,1769,302101,0.1695873374788016,0.2052006783493499,0.6252119841718485,6
302102,290,291,916,1497,302102,0.19372077488309952,0.19438877755511022,0.6118904475617902,6
302200,386,480,1056,1922,302200,0.2008324661810614,0.2497398543184183,0.5494276795005203,6
302300,433,470,1305,2208,302300,0.19610507246376813,0.2128623188405797,0.5910326086956522,6
302400,506,621,1425,2552,302400,0.19827586206896552,0.24333855799373041,0.5583855799373041,6
302501,222,230,738,1190,302501,0.1865546218487395,0.19327731092436976,0.6201680672268908,6
302502,176,263,705,1144,302502,0.15384615384615385,0.2298951048951049,0.6162587412587412,6
302600,224,281,641,1146,302600,0.19546247818499127,0.24520069808027922,0.5593368237347295,6
302700,406,451,1149,2006,302700,0.2023928215353938,0.22482552342971088,0.5727816550348953,6
302800,614,677,1698,2989,302800,0.20541987286717966,0.226497156239545,0.5680829708932753,6
302900,441,475,1162,2078,302900,0.212223291626564,0.2285851780558229,0.559191530317613,6
303000,547,647,1515,2709,303000,0.20191952750092285,0.23883351790328536,0.5592469545957918,6
303101,330,312,920,1562,303101,0.2112676056338028,0.1997439180537772,0.58898847631242,6
303102,396,510,1175,2081,303102,0.19029312830370015,0.245074483421432,0.5646323882748678,6
303201,368,443,1060,1871,303201,0.19668626402993053,0.23677177979690006,0.5665419561731694,6
303202,393,503,1019,1915,303202,0.20522193211488252,0.26266318537859007,0.5321148825065274,6
303301,337,366,997,1700,303301,0.19823529411764707,0.21529411764705883,0.5864705882352941,6
303302,500,519,1238,2257,303302,0.22153300841825432,0.22995126273814798,0.5485157288435977,6
303400,275,223,763,1261,303400,0.21808088818398097,0.17684377478191912,0.6050753370340999,6
303500,510,606,1515,2631,303500,0.19384264538198404,0.23033067274800456,0.5758266818700114,6
303600,688,924,2023,3635,303600,0.18927097661623107,0.25419532324621735,0.5565337001375515,6
303700,674,804,2029,3507,303700,0.19218705446250356,0.2292557741659538,0.5785571713715426,6
303800,588,798,1655,3041,303800,0.19335744820782638,0.2624136797106215,0.5442288720815521,6
303900,518,588,1088,2194,303900,0.23609845031905197,0.268003646308113,0.495897903372835,6
304001,355,410,916,1681,304001,0.2111838191552647,0.24390243902439024,0.544913741820345,6
304002,508,721,1248,2477,304002,0.20508679854662898,0.2910779168348809,0.5038352846184901,6
304100,551,819,1020,2390,304100,0.2305439330543933,0.3426778242677824,0.42677824267782427,5
304202,517,764,809,2090,304202,0.24736842105263157,0.36555023923444974,0.38708133971291864,5
304203,821,1417,1153,3391,304203,0.2421114715423179,0.4178708345620761,0.34001769389560604,5
304204,657,1039,822,2518,304204,0.26092136616362194,0.4126290706910246,0.32644956314535345,5
401200,555,759,725,2039,401200,0.2721922511034821,0.3722412947523296,0.3555664541441883,5
401300,804,1075,1131,3010,401300,0.267109634551495,0.35714285714285715,0.37574750830564785,5
404300,413,477,935,1825,404300,0.2263013698630137,0.26136986301369863,0.5123287671232877,6
404400,548,545,1521,2614,404400,0.20964039785768937,0.20849273144605968,0.581866870696251,6
404500,481,558,1281,2320,404500,0.20732758620689656,0.24051724137931035,0.5521551724137931,6
404600,530,553,1311,2394,404600,0.22138680033416874,0.2309941520467836,0.5476190476190477,6
404700,689,834,1841,3364,404700,0.20481569560047563,0.2479191438763377,0.5472651605231866,6
404800,811,1119,1630,3560,404800,0.22780898876404496,0.3143258426966292,0.45786516853932585,5
404901,596,1021,1309,2926,404901,0.20369104579630895,0.34894053315105944,0.4473684210526316,5
404902,455,810,928,2193,404902,0.20747834017327862,0.3693570451436389,0.42316461468308253,5
405000,567,793,1233,2593,405000,0.21866563825684535,0.30582337061318937,0.4755109911299653,5
405100,763,1174,1957,3894,405100,0.19594247560349257,0.30148947098099643,0.502568053415511,5
405200,610,1006,1493,3109,405200,0.19620456738501127,0.3235767127693792,0.48021871984560954,5
405301,342,391,983,1716,405301,0.1993006993006993,0.22785547785547786,0.5728438228438228,6
405302,475,528,1144,2147,405302,0.22123893805309736,0.24592454587796925,0.5328365160689333,6
405400,690,1051,1983,3724,405400,0.18528464017185822,0.2822234156820623,0.5324919441460795,6
405500,533,679,1477,2689,405500,0.198214949795463,0.25251022685013014,0.5492748233544068,6
405600,445,528,1176,2149,405600,0.20707305723592367,0.24569567240577012,0.5472312703583062,6
405700,473,570,1335,2378,405700,0.19890664423885618,0.2396972245584525,0.5613961312026914,6
405800,408,448,1182,2038,405800,0.20019627085377822,0.2198233562315996,0.5799803729146222,6
405900,550,601,1317,2468,405900,0.22285251215559157,0.24351701782820098,0.5336304700162074,6
406001,503,665,1243,2411,406001,0.2086271256739942,0.27581916217337205,0.5155537121526338,6
406002,330,369,787,1486,406002,0.22207267833109018,0.24831763122476447,0.5296096904441454,6
406100,354,404,809,1567,406100,0.22590938098276964,0.25781748564135293,0.5162731333758774,6
406201,311,446,857,1614,406201,0.1926889714993804,0.27633209417596033,0.5309789343246593,6
406202,643,945,1571,3159,406202,0.203545425767648,0.29914529914529914,0.49730927508705286,6
406300,330,368,1110,1808,406300,0.18252212389380532,0.20353982300884957,0.6139380530973452,6
406400,517,523,1798,2838,406400,0.1821705426356589,0.18428470754052148,0.6335447498238196,6
406501,527,587,1805,2919,406501,0.18054128126070573,0.20109626584446727,0.6183624528948269,6
406600,356,356,1221,1933,406600,0.18416968442834972,0.18416968442834972,0.6316606311433006,6
406701,400,571,523,1494,406701,0.2677376171352075,0.3821954484605087,0.3500669344042838,5
406702,662,769,941,2372,406702,0.2790893760539629,0.3241989881956155,0.39671163575042157,5
406801,504,886,532,1922,406801,0.26222684703433924,0.46097814776274715,0.2767950052029136,4
406802,525,966,704,2195,406802,0.23917995444191345,0.44009111617312074,0.32072892938496583,5
406900,872,1232,1090,3194,406900,0.27301189730745146,0.3857232310582342,0.34126487163431435,5
407000,832,1233,1021,3086,407000,0.2696046662346079,0.3995463383020091,0.33084899546338303,5
407101,579,941,797,2317,407101,0.2498921018558481,0.40612861458782906,0.34397928355632285,5
407102,590,1035,937,2562,407102,0.2302888368462139,0.40398126463700235,0.3657298985167838,5
407201,544,816,561,1921,407201,0.2831858407079646,0.4247787610619469,0.2920353982300885,4
407203,428,628,525,1581,407203,0.27071473750790637,0.3972169512966477,0.33206831119544594,5
407204,271,483,440,1194,407204,0.2269681742043551,0.4045226130653266,0.3685092127303183,5
407301,430,438,829,1697,407301,0.253388332351208,0.2581025338833235,0.48850913376546845,6
407302,567,982,847,2396,407302,0.23664440734557596,0.40984974958263776,0.3535058430717863,5
407401,720,1078,994,2792,407401,0.25787965616045844,0.3861031518624642,0.3560171919770774,5
407402,426,672,583,1681,407402,0.25342058298631764,0.3997620464009518,0.3468173706127305,5
407501,631,995,822,2448,407501,0.2577614379084967,0.40645424836601307,0.33578431372549017,5
407502,696,1110,993,2799,407502,0.24866023579849947,0.3965702036441586,0.35476956055734193,5
407600,558,670,1543,2771,407600,0.20137134608444604,0.24178996752075063,0.5568386863948033,6
407700,509,630,1371,2510,407700,0.20278884462151395,0.250996015936255,0.5462151394422311,6
407801,598,751,1438,2787,407801,0.214567635450305,0.2694653749551489,0.5159669895945461,6
407802,141,164,376,681,407802,0.20704845814977973,0.24082232011747431,0.5521292217327459,6
407900,606,618,1437,2661,407900,0.2277339346110485,0.2322435174746336,0.5400225479143179,6
408000,859,864,1938,3661,408000,0.2346353455340071,0.23600109259765092,0.529363561868342,6
408100,909,969,2036,3914,408100,0.23224322943280531,0.24757281553398058,0.5201839550332141,6
408200,978,1058,2021,4057,408200,0.24106482622627556,0.26078383041656394,0.49815134335716044,6
408300,913,985,2151,4049,408300,0.22548777475919982,0.24326994319585082,0.5312422820449494,6
408400,442,385,1259,2086,408400,0.21188878235858102,0.18456375838926176,0.6035474592521572,6
408500,666,657,1781,3104,408500,0.21456185567010308,0.21166237113402062,0.5737757731958762,6
408600,498,620,1284,2402,408600,0.2073272273105745,0.2581182348043297,0.5345545378850958,6
408700,536,701,1362,2599,408700,0.20623316660253943,0.2697191227395152,0.5240477106579453,6
408800,812,954,1978,3744,408800,0.2168803418803419,0.2548076923076923,0.5283119658119658,6
408900,649,860,1647,3156,408900,0.2056400506970849,0.27249683143219267,0.5218631178707225,6
409000,784,827,1640,3251,409000,0.2411565672100892,0.2543832666871732,0.5044601661027376,6
409100,646,750,1576,2972,409100,0.2173620457604307,0.25235531628532976,0.5302826379542396,6
409200,673,793,1737,3203,409200,0.21011551670309087,0.24758039338120513,0.542304089915704,6
409300,529,561,1242,2332,409300,0.22684391080617497,0.24056603773584906,0.532590051457976,6
409400,504,590,1258,2352,409400,0.21428571428571427,0.2508503401360544,0.5348639455782312,6
409500,444,454,1215,2113,409500,0.21012778040700425,0.21486038807382868,0.575011831519167,6
409600,569,656,1412,2637,409600,0.21577550246492225,0.24876753886992795,0.5354569586651498,6
409700,460,457,1220,2137,409700,0.21525503041647168,0.21385119326158167,0.5708937763219466,6
409800,544,800,1353,2697,409800,0.20170559881349648,0.29662588060808304,0.5016685205784205,6
409900,733,1035,1875,3643,409900,0.2012077957727148,0.28410650562723033,0.5146856986000549,6
410000,650,687,1382,2719,410000,0.23905847738139022,0.2526664214784847,0.5082751011401251,6
410100,599,609,1656,2864,410100,0.20914804469273743,0.21263966480446927,0.5782122905027933,6
410200,369,468,1132,1969,410200,0.18740477399695277,0.23768410360589132,0.5749111223971559,6
410300,716,1017,1562,3295,410300,0.217298937784522,0.308649468892261,0.474051593323217,5
410400,598,867,1363,2828,410400,0.21145685997171146,0.3065770862800566,0.481966053748232,5
410500,863,1098,1893,3854,410500,0.2239231966787753,0.28489880643487286,0.49117799688635183,6
410600,841,1027,2093,3961,410600,0.21232012118151983,0.25927796011108306,0.5284019187073972,6
410700,780,938,1892,3610,410700,0.21606648199445982,0.2598337950138504,0.5240997229916897,6
410800,554,763,1408,2725,410800,0.20330275229357797,0.28,0.516697247706422,6
410900,457,665,1290,2412,410900,0.189469320066335,0.27570480928689883,0.5348258706467661,6
411000,524,719,1048,2291,411000,0.22872108249672632,0.313836752509821,0.45744216499345264,5
411100,454,668,791,1913,411100,0.23732357553580763,0.349189754312598,0.41348667015159435,5
411200,568,702,1410,2680,411200,0.21194029850746268,0.2619402985074627,0.5261194029850746,6
411301,303,338,829,1470,411301,0.20612244897959184,0.22993197278911565,0.5639455782312925,6
411302,472,540,1474,2486,411302,0.1898632341110217,0.2172164119066774,0.5929203539823009,6
411400,542,583,1456,2581,411400,0.20999612553273925,0.225881441301821,0.5641224331654398,6
411500,214,270,754,1238,411500,0.172859450726979,0.21809369951534732,0.6090468497576736,6
411600,486,463,1387,2336,411600,0.20804794520547945,0.19820205479452055,0.59375,6
411700,605,715,1700,3020,411700,0.20033112582781457,0.2367549668874172,0.5629139072847682,6
411800,593,754,1683,3030,411800,0.1957095709570957,0.24884488448844885,0.5554455445544555,6
411901,340,435,908,1683,411901,0.20202020202020202,0.25846702317290554,0.5395127748068924,6
411902,366,449,986,1801,411902,0.20322043309272628,0.249305941143809,0.5474736257634647,6
412000,656,756,1555,2967,412000,0.22109875294910683,0.25480283114256824,0.524098415908325,6
412100,610,658,1663,2931,412100,0.20812009553053565,0.2244967587853975,0.5673831456840669,6
412200,515,584,1489,2588,412200,0.1989953632148377,0.22565687789799072,0.5753477588871716,6
412301,329,361,938,1628,412301,0.20208845208845208,0.22174447174447173,0.5761670761670762,6
412302,412,450,1088,1950,412302,0.21128205128205127,0.23076923076923078,0.5579487179487179,6
412400,527,573,1432,2532,412400,0.20813586097946288,0.22630331753554503,0.5655608214849921,6
412500,387,387,1196,1970,412500,0.1964467005076142,0.1964467005076142,0.6071065989847716,6
412600,285,264,1017,1566,412600,0.18199233716475097,0.1685823754789272,0.6494252873563219,6
412700,357,311,1108,1776,412700,0.20101351351351351,0.1751126126126126,0.6238738738738738,6
412800,386,506,1023,1915,412800,0.20156657963446475,0.26422976501305484,0.5342036553524804,6
412900,808,923,1736,3467,412900,0.2330545139890395,0.26622440149985577,0.5007210845111048,6
413001,561,604,1353,2518,413001,0.2227958697378872,0.2398729150119142,0.5373312152501986,6
413002,493,538,1165,2196,413002,0.22449908925318762,0.24499089253187614,0.5305100182149363,6
413100,680,742,1689,3111,413100,0.2185792349726776,0.2385085181613629,0.5429122468659595,6
413200,766,883,2036,3685,413200,0.2078697421981004,0.23962008141112617,0.5525101763907734,6
413300,754,796,2120,3670,413300,0.20544959128065396,0.21689373297002726,0.5776566757493188,6
413400,511,582,1582,2675,413400,0.19102803738317756,0.21757009345794392,0.5914018691588785,6
413500,727,937,1879,3543,413500,0.205193338978267,0.2644651425345752,0.5303415184871578,6
413600,525,732,1477,2734,413600,0.1920263350402341,0.2677395757132407,0.5402340892465253,6
413700,533,642,1444,2619,413700,0.20351279114165713,0.24513172966781213,0.5513554791905307,6
413803,421,437,1196,2054,413803,0.20496592015579357,0.2127555988315482,0.5822784810126582,6
413804,420,488,1056,1964,413804,0.21384928716904278,0.2484725050916497,0.5376782077393075,6
413900,761,1357,1168,3286,413900,0.23158855751673768,0.41296409007912355,0.35544735240413877,5
414001,435,726,681,1842,414001,0.23615635179153094,0.3941368078175896,0.3697068403908795,5
414002,535,909,713,2157,414002,0.2480296708391284,0.42141863699582754,0.33055169216504404,5
414100,658,1069,1085,2812,414100,0.23399715504978663,0.38015647226173543,0.38584637268847793,5
414201,521,898,793,2212,414201,0.23553345388788427,0.40596745027124775,0.358499095840868,5
414202,471,841,670,1982,414202,0.23763874873864782,0.4243188698284561,0.33804238143289606,5
414301,402,625,560,1587,414301,0.2533081285444234,0.39382482671707625,0.35286704473850034,5
414303,498,741,849,2088,414303,0.23850574712643677,0.35488505747126436,0.40660919540229884,5
414304,454,663,459,1576,414304,0.2880710659898477,0.4206852791878173,0.29124365482233505,4
414400,533,910,718,2161,414400,0.24664507172605277,0.4211013419713096,0.3322535863026377,5
414501,590,768,1197,2555,414501,0.2309197651663405,0.300587084148728,0.4684931506849315,5
414502,440,653,996,2089,414502,0.2106270943034945,0.3125897558640498,0.47678314983245573,5
414600,415,401,1144,1960,414600,0.21173469387755103,0.2045918367346939,0.5836734693877551,6
414700,443,543,1426,2412,414700,0.18366500829187396,0.22512437810945274,0.5912106135986733,6
414800,807,766,1935,3508,414800,0.23004561003420754,0.21835803876852908,0.5515963511972634,6
414900,792,767,2073,3632,414900,0.21806167400881057,0.2111784140969163,0.5707599118942731,6
415000,652,652,1727,3031,415000,0.21511052457934676,0.21511052457934676,0.5697789508413065,6
415101,309,258,862,1429,415101,0.21623512946116166,0.18054583624912526,0.6032190342897131,6
415102,450,440,1533,2423,415102,0.18572018159306644,0.18159306644655385,0.6326867519603797,6
415201,358,319,1068,1745,415201,0.20515759312320916,0.1828080229226361,0.6120343839541548,6
415202,426,367,1254,2047,415202,0.20810942843185148,0.1792867611138251,0.6126038104543234,6
415300,688,704,1857,3249,415300,0.21175746383502617,0.21668205601723609,0.5715604801477377,6
415401,529,608,1572,2709,415401,0.1952750092284976,0.22443706164636398,0.5802879291251384,6
415402,461,458,1339,2258,415402,0.204162976085031,0.20283436669619131,0.5930026572187777,6
415500,346,321,738,1405,415500,0.24626334519572954,0.22846975088967972,0.5252669039145907,6
415600,660,558,1733,2951,415600,0.22365299898339547,0.18908844459505253,0.587258556421552,6
415700,736,711,2015,3462,415700,0.21259387637203928,0.20537261698440207,0.5820335066435587,6
415802,867,824,2328,4019,415802,0.2157253048021896,0.20502612590196567,0.5792485692958448,6
416000,573,544,1318,2435,416000,0.2353182751540041,0.22340862422997945,0.5412731006160164,6
416100,846,821,2047,3714,416100,0.22778675282714056,0.22105546580506194,0.5511577813677975,6
416201,382,456,997,1835,416201,0.20817438692098092,0.24850136239782017,0.5433242506811989,6
416202,511,558,1112,2181,416202,0.23429619440623567,0.2558459422283356,0.5098578633654287,6
416300,305,368,945,1618,416300,0.188504326328801,0.22744128553770088,0.5840543881334982,6
416401,263,313,1004,1580,416401,0.16645569620253164,0.1981012658227848,0.6354430379746835,6
416402,317,384,896,1597,416402,0.19849718221665624,0.24045084533500313,0.5610519724483406,6
416500,682,827,1367,2876,416500,0.23713490959666203,0.2875521557719054,0.47531293463143254,6
416600,521,595,1581,2697,416600,0.1931776047460141,0.22061549870226177,0.5862068965517241,6
416701,469,533,1202,2204,416701,0.21279491833030853,0.24183303085299457,0.5453720508166969,6
416702,448,471,1161,2080,416702,0.2153846153846154,0.2264423076923077,0.5581730769230769,6
416801,229,265,678,1172,416801,0.19539249146757678,0.22610921501706485,0.5784982935153583,6
416802,406,449,1240,2095,416802,0.1937947494033413,0.2143198090692124,0.5918854415274463,6
416900,348,355,1149,1852,416900,0.1879049676025918,0.19168466522678185,0.6204103671706264,6
490100,456,540,503,1499,490100,0.30420280186791193,0.3602401601067378,0.33555703802535025,3
490200,477,576,830,1883,490200,0.2533191715347849,0.30589484864577804,0.44078597981943707,5
490300,648,951,925,2524,490300,0.25673534072900156,0.37678288431061807,0.36648177496038037,5
490400,365,452,672,1489,490400,0.24513096037609133,0.3035594358629953,0.4513096037609134,5
490500,455,561,646,1662,490500,0.27376654632972325,0.33754512635379064,0.38868832731648617,5
490600,532,699,762,1993,490600,0.26693426994480685,0.3507275464124435,0.38233818364274963,5
490700,602,900,939,2441,490700,0.2466202376075379,0.368701351904957,0.3846784104875051,5
490800,280,293,499,1072,490800,0.26119402985074625,0.2733208955223881,0.46548507462686567,6
490900,344,358,463,1165,490900,0.2952789699570815,0.3072961373390558,0.39742489270386266,5
491000,434,580,617,1631,491000,0.26609442060085836,0.35561005518087063,0.378295524218271,5
491100,27,46,50,123,491100,0.21951219512195122,0.37398373983739835,0.4065040650406504,5
491200,35,30,46,111,491200,0.3153153153153153,0.2702702702702703,0.4144144144144144,2
491300,336,531,482,1349,491300,0.2490733876945886,0.3936249073387695,0.35730170496664193,5
491400,331,477,392,1200,491400,0.2758333333333333,0.3975,0.32666666666666666,5
491500,310,480,401,1191,491500,0.26028547439126787,0.40302267002518893,0.33669185558354325,5
491600,203,388,215,806,491600,0.2518610421836228,0.4813895781637717,0.2667493796526055,4
491700,352,525,519,1396,491700,0.2521489971346705,0.37607449856733527,0.37177650429799425,5
491800,306,413,366,1085,491800,0.2820276497695853,0.38064516129032255,0.33732718894009217,5
491900,29,27,21,77,491900,0.37662337662337664,0.35064935064935066,0.2727272727272727,1
492000,496,538,707,1741,492000,0.2848937392303274,0.3090178058587019,0.40608845491097073,5
492100,300,398,387,1085,492100,0.2764976958525346,0.36682027649769583,0.3566820276497696,5
492300,518,640,717,1875,492300,0.27626666666666666,0.3413333333333333,0.3824,5
492400,192,341,286,819,492400,0.23443223443223443,0.4163614163614164,0.3492063492063492,5
492500,127,174,169,470,492500,0.2702127659574468,0.3702127659574468,0.3595744680851064,5
492600,484,624,581,1689,492600,0.28656009473060984,0.369449378330373,0.34399052693901716,5
492700,503,566,514,1583,492700,0.31775110549589386,0.35754895767530004,0.32469993682880605,3
492800,194,313,262,769,492800,0.25227568270481143,0.4070221066319896,0.34070221066319895,5
492900,144,207,190,541,492900,0.266173752310536,0.3826247689463956,0.3512014787430684,5
517000,276,402,872,1550,517000,0.17806451612903226,0.2593548387096774,0.5625806451612904,6
517101,540,745,1202,2487,517101,0.21712907117008443,0.2995577000402091,0.48331322878970645,6
517102,237,304,634,1175,517102,0.20170212765957446,0.25872340425531914,0.5395744680851063,6
517200,889,1131,1619,3639,517200,0.2442978840340753,0.3107996702390767,0.44490244572684806,5
517301,331,406,720,1457,517301,0.22717913520933425,0.2786547700754976,0.49416609471516815,6
517302,454,673,1146,2273,517302,0.19973603167619886,0.29608446986361636,0.5041794984601847,6
517400,501,468,1351,2320,517400,0.21594827586206897,0.20172413793103447,0.5823275862068965,6
517500,397,369,1133,1899,517500,0.20905739863085834,0.1943127962085308,0.5966298051606108,6
517600,489,612,1396,2497,517600,0.1958350020024029,0.24509411293552263,0.5590708850620745,6
517701,634,663,1964,3261,517701,0.19441888991107023,0.20331186752529898,0.6022692425636308,6
517705,266,264,712,1242,517705,0.214170692431562,0.21256038647342995,0.573268921095008,6
517801,302,315,958,1575,517801,0.19174603174603175,0.2,0.6082539682539683,6
517802,386,437,986,1809,517802,0.21337755666113875,0.24156992813709233,0.5450525152017689,6
517901,542,537,1522,2601,517901,0.20838139177239523,0.20645905420991925,0.5851595540176855,6
517902,357,367,800,1524,517902,0.234251968503937,0.24081364829396326,0.5249343832020997,6
518000,647,700,1806,3153,518000,0.2052013954963527,0.22201078338090707,0.5727878211227403,6
518100,298,292,893,1483,518100,0.200944032366824,0.1968981793661497,0.6021577882670263,6
518201,295,321,1192,1808,518201,0.16316371681415928,0.17754424778761063,0.6592920353982301,6
518203,303,330,1070,1703,518203,0.17792131532589547,0.19377568995889607,0.6283029947152085,6
518204,399,410,1236,2045,518204,0.19511002444987774,0.20048899755501223,0.6044009779951101,6
518300,450,489,1491,2430,518300,0.18518518518518517,0.20123456790123456,0.6135802469135803,6
518400,297,429,1161,1887,518400,0.1573926868044515,0.2273449920508744,0.615262321144674,6
518501,523,586,1592,2701,518501,0.1936319881525361,0.21695668271010737,0.5894113291373565,6
518502,298,363,828,1489,518502,0.20013431833445267,0.24378777703156482,0.5560779046339825,6
518600,359,381,1078,1818,518600,0.19746974697469746,0.20957095709570958,0.592959295929593,6
518700,460,522,1487,2469,518700,0.1863102470635885,0.21142162818955043,0.6022681247468611,6
518800,306,278,943,1527,518800,0.20039292730844793,0.18205631958087753,0.6175507531106745,6
518900,789,969,1857,3615,518900,0.21825726141078838,0.2680497925311203,0.5136929460580912,6
519000,650,885,1677,3212,519000,0.20236612702366127,0.27552926525529264,0.522104607721046,6
519100,659,786,1678,3123,519100,0.21101504963176432,0.2516810758885687,0.537303874479667,6
519200,714,811,1681,3206,519200,0.22270742358078602,0.25296319401122896,0.524329382407985,6
519300,735,901,1563,3199,519300,0.22975929978118162,0.28165051578618316,0.4885901844326352,6
519400,503,584,1216,2303,519400,0.21841076856274425,0.2535822839774208,0.528006947459835,6
519500,692,774,1669,3135,519500,0.22073365231259967,0.24688995215311005,0.5323763955342903,6
519601,426,438,1212,2076,519601,0.20520231213872833,0.21098265895953758,0.5838150289017341,6
519602,240,248,705,1193,519602,0.20117351215423301,0.20787929589270746,0.5909471919530596,6
519702,501,532,1473,2506,519702,0.19992019154030327,0.2122905027932961,0.5877893056664006,6
519703,395,415,1072,1882,519703,0.20988310308182784,0.22051009564293306,0.5696068012752391,6
519704,408,347,943,1698,519704,0.24028268551236748,0.2043580683156655,0.555359246171967,6
519801,324,286,819,1429,519801,0.22673198040587825,0.2001399580125962,0.5731280615815255,6
519802,568,564,1530,2662,519802,0.21337340345604808,0.21187077385424494,0.574755822689707,6
519900,637,684,1683,3004,519900,0.21205059920106525,0.22769640479360853,0.5602529960053262,6
520001,884,851,1935,3670,520001,0.24087193460490464,0.23188010899182562,0.5272479564032697,6
520002,563,570,1289,2422,520002,0.2324525185796862,0.23534269199009084,0.532204789430223,6
520100,579,567,1548,2694,520100,0.21492204899777284,0.21046770601336304,0.5746102449888641,6
520200,362,435,934,1731,520200,0.20912767186597342,0.2512998266897747,0.5395725014442518,6
520300,687,712,1684,3083,520300,0.22283490107038598,0.23094388582549466,0.5462212131041194,6
520401,474,487,1264,2225,520401,0.21303370786516854,0.21887640449438203,0.5680898876404494,6
520402,441,593,1202,2236,520402,0.1972271914132379,0.2652057245080501,0.537567084078712,6
520501,473,498,1139,2110,520501,0.2241706161137441,0.23601895734597156,0.5398104265402843,6
520502,626,664,1669,2959,520502,0.21155795876985467,0.22440013518080432,0.564041906049341,6
520600,693,751,1718,3162,520600,0.21916508538899432,0.2375079063883618,0.5433270082226439,6
520700,535,630,1403,2568,520700,0.20833333333333334,0.24532710280373832,0.5463395638629284,6
520800,485,442,1158,2085,520800,0.23261390887290168,0.2119904076738609,0.5553956834532374,6
520900,616,543,1284,2443,520900,0.2521489971346705,0.2222677036430618,0.5255832992222677,6
521000,573,613,1425,2611,521000,0.2194561470700881,0.23477594791267714,0.5457679050172348,6
521100,563,632,1341,2536,521100,0.2220031545741325,0.24921135646687698,0.5287854889589906,6
521200,386,437,911,1734,521200,0.22260668973471742,0.2520184544405998,0.5253748558246828,6
521301,325,325,809,1459,521301,0.2227553118574366,0.2227553118574366,0.5544893762851268,6
521302,695,701,1725,3121,521302,0.22268503684716437,0.22460749759692406,0.5527074655559115,6
521400,819,721,2047,3587,521400,0.22832450515751324,0.20100362419849457,0.5706718706439922,6
521500,657,600,1542,2799,521500,0.2347266881028939,0.21436227224008575,0.5509110396570204,6
521601,512,494,1285,2291,521601,0.2234831951113051,0.21562636403317328,0.5608904408555216,6
521602,404,388,1052,1844,521602,0.21908893709327548,0.210412147505423,0.5704989154013015,6
521700,502,489,1308,2299,521700,0.2183558068725533,0.21270117442366246,0.5689430187037843,6
521801,420,416,1097,1933,521801,0.2172788411795137,0.21520951888256595,0.5675116399379203,6
521802,413,459,1240,2112,521802,0.19554924242424243,0.21732954545454544,0.5871212121212122,6
521902,480,499,1362,2341,521902,0.20504058094831268,0.21315677061085006,0.5818026484408373,6
522000,871,1091,1861,3823,522000,0.22783154590635626,0.2853779754119801,0.48679047868166364,6
522700,689,549,1693,2931,522700,0.2350733538041624,0.18730808597748208,0.5776185602183556,6
590100,482,701,706,1889,590100,0.25516146109052407,0.3710958178930651,0.3737427210164108,5
590201,221,371,337,929,590201,0.2378902045209903,0.3993541442411195,0.3627556512378902,5
590202,433,524,782,1739,590202,0.24899367452558943,0.30132259919493964,0.44968372627947095,5
590300,408,687,559,1654,590300,0.24667472793228537,0.4153567110036276,0.33796856106408707,5
590400,521,989,804,2314,590400,0.22515125324114088,0.42739844425237683,0.3474503025064823,5
590500,332,496,445,1273,590500,0.2608012568735271,0.389630793401414,0.3495679497250589,5
590600,203,335,239,777,590600,0.26126126126126126,0.43114543114543114,0.3075933075933076,5
590700,371,606,473,1450,590700,0.2558620689655172,0.41793103448275865,0.32620689655172413,5
590800,555,732,821,2108,590800,0.26328273244781786,0.34724857685009486,0.3894686907020873,5
590900,300,365,376,1041,590900,0.2881844380403458,0.3506243996157541,0.3611911623439001,5
591000,330,374,451,1155,591000,0.2857142857142857,0.3238095238095238,0.3904761904761905,5
591100,359,434,325,1118,591100,0.3211091234347048,0.3881932021466905,0.29069767441860467,1
591200,168,218,264,650,591200,0.25846153846153846,0.3353846153846154,0.40615384615384614,5
591300,73,91,123,287,591300,0.25435540069686413,0.3170731707317073,0.42857142857142855,5
591400,564,908,736,2208,591400,0.2554347826086957,0.411231884057971,0.3333333333333333,5
591500,349,577,535,1461,591500,0.23887748117727584,0.3949349760438056,0.3661875427789186,5
591600,392,630,605,1627,591600,0.24093423478795328,0.38721573448063923,0.3718500307314075,5
610000,89,105,212,406,610000,0.21921182266009853,0.25862068965517243,0.5221674876847291,6
640001,15,12,15,42,640001,0.35714285714285715,0.2857142857142857,0.35714285714285715,2
640002,35,51,90,176,640002,0.19886363636363635,0.2897727272727273,0.5113636363636364,6
740100,472,641,581,1694,740100,0.27863046044864226,0.37839433293978747,0.34297520661157027,5
740200,581,693,709,1983,740200,0.2929904185577408,0.3494704992435703,0.35753908219868885,5
740300,69,86,70,225,740300,0.30666666666666664,0.38222222222222224,0.3111111111111111,3
740400,565,908,681,2154,740400,0.26230269266480966,0.4215413184772516,0.3161559888579387,5
740500,445,586,502,1533,740500,0.2902804957599478,0.3822570123939987,0.32746249184605347,5
740600,291,443,474,1208,740600,0.24089403973509935,0.3667218543046358,0.3923841059602649,5
740700,466,615,592,1673,740700,0.2785415421398685,0.36760310818888225,0.35385534967124926,5
740800,329,450,459,1238,740800,0.265751211631664,0.36348949919224555,0.37075928917609047,5
940000,861,1373,1222,3456,940000,0.24913194444444445,0.3972800925925926,0.35358796296296297,5
940001,126,167,134,427,940001,0.29508196721311475,0.3911007025761124,0.31381733021077285,5
940100,736,1133,897,2766,940100,0.2660882140274765,0.4096167751265365,0.324295010845987,5
940101,324,503,266,1093,940101,0.29643183897529735,0.4602012808783166,0.2433668801463861,4
940102,779,1081,927,2787,940102,0.2795120200932903,0.38787226408324366,0.3326157158234661,5
940103,679,827,1110,2616,940103,0.2595565749235474,0.316131498470948,0.4243119266055046,5
940200,1249,1687,1752,4688,940200,0.2664249146757679,0.35985494880546076,0.37372013651877134,5
940300,1770,2473,1913,6156,940300,0.2875243664717349,0.40172189733593244,0.3107537361923327,5
940401,958,1168,1539,3665,940401,0.26139154160982264,0.31869031377899043,0.4199181446111869,5
940403,609,845,951,2405,940403,0.25322245322245324,0.35135135135135137,0.39542619542619545,5
940600,900,1320,1159,3379,940600,0.2663509914175792,0.39064812074578276,0.34300088783663807,5
940700,390,464,636,1490,940700,0.26174496644295303,0.31140939597315437,0.4268456375838926,5
950100,3971,5318,5923,15212,950100,0.2610439127004996,0.34959242703129106,0.3893636602682093,5
950200,3544,5025,4923,13492,950200,0.26267417729024606,0.372442929143196,0.36488289356655795,5
950300,4994,6457,6551,18002,950300,0.27741362070881015,0.35868236862570824,0.3639040106654816,5
950400,4259,5589,5626,15474,950400,0.27523587953987333,0.3611865063978286,0.36357761406229805,5
950500,3218,4032,3936,11186,950500,0.287681029858752,0.360450563204005,0.351868406937243,5
950501,358,413,374,1145,950501,0.31266375545851527,0.36069868995633186,0.3266375545851528,3
950502,229,289,289,807,950502,0.28376703841387857,0.35811648079306074,0.35811648079306074,5
950600,2375,3050,2900,8325,950600,0.2852852852852853,0.3663663663663664,0.3483483483483483,5
950700,2868,3655,3273,9796,950700,0.29277256022866477,0.3731114740710494,0.33411596570028584,5
950800,2151,2529,2623,7303,950800,0.2945364918526633,0.34629604272216896,0.35916746542516775,5
950900,2245,2811,2680,7736,950900,0.2902016546018614,0.36336608066184073,0.34643226473629785,5
951000,2155,2638,2736,7529,951000,0.2862265905166689,0.35037853632620536,0.36339487315712576,5
951100,2004,2618,2974,7596,951100,0.2638230647709321,0.3446550816219063,0.3915218536071617,5
951200,2736,3662,4196,10594,951200,0.25825939210874077,0.34566735888238626,0.396073249008873,5
951300,1796,2504,2821,7121,951300,0.2522117680101109,0.35163600617890745,0.3961522258109816,5
951400,1244,1446,1734,4424,951400,0.28119349005424954,0.3268535262206148,0.39195298372513565,5
951500,778,931,1229,2938,951500,0.26480599046970726,0.31688223281143635,0.4183117767188564,5
951600,647,939,1110,2696,951600,0.23998516320474778,0.3482937685459941,0.41172106824925814,5
951700,1113,1465,1878,4456,951700,0.24977558348294435,0.328770197486535,0.42145421903052066,5
951800,928,1337,1041,3306,951800,0.2807017543859649,0.4044162129461585,0.31488203266787657,5
951900,650,838,943,2431,951900,0.26737967914438504,0.34471410941999175,0.3879062114356232,5
952000,783,1024,1030,2837,952000,0.27599577017976734,0.3609446598519563,0.3630595699682764,5
952100,925,1123,1117,3165,952100,0.292259083728278,0.3548183254344392,0.3529225908372828,5
952200,602,840,1104,2546,952200,0.23644933228593873,0.32992930086410055,0.4336213668499607,5
952300,380,564,529,1473,952300,0.25797691785471827,0.38289205702647655,0.3591310251188052,5
952400,620,691,864,2175,952400,0.2850574712643678,0.3177011494252874,0.3972413793103448,5
952500,596,751,940,2287,952500,0.2606034105815479,0.32837778749453433,0.4110188019239178,5
952600,450,537,709,1696,952600,0.2653301886792453,0.31662735849056606,0.4180424528301887,5
952700,242,255,348,845,952700,0.2863905325443787,0.30177514792899407,0.41183431952662725,5
952800,303,382,491,1176,952800,0.2576530612244898,0.32482993197278914,0.4175170068027211,5
952900,484,542,885,1911,952900,0.2532705389848247,0.2836211407639979,0.4631083202511774,6
953000,187,231,272,690,953000,0.2710144927536232,0.3347826086956522,0.39420289855072466,5
953300,391,423,751,1565,953300,0.2498402555910543,0.2702875399361022,0.47987220447284346,6
953400,376,416,522,1314,953400,0.2861491628614916,0.3165905631659056,0.3972602739726027,5
953500,246,232,350,828,953500,0.2971014492753623,0.28019323671497587,0.4227053140096618,6
953600,504,614,928,2046,953600,0.24633431085043989,0.30009775171065495,0.45356793743890517,5
953700,547,657,957,2161,953700,0.25312355391022673,0.3040259139287367,0.44285053216103654,5
953800,341,424,549,1314,953800,0.2595129375951294,0.3226788432267884,0.4178082191780822,5
953900,466,505,775,1746,953900,0.26689576174112256,0.28923253150057276,0.4438717067583047,6
954000,450,616,772,1838,954000,0.24483133841131666,0.33514689880304677,0.4200217627856366,5
954100,430,634,720,1784,954100,0.24103139013452915,0.35538116591928254,0.40358744394618834,5
954200,432,554,865,1851,954200,0.233387358184765,0.2992976769313884,0.46731496488384655,6
954400,566,730,1102,2398,954400,0.23603002502085071,0.30442035029190995,0.45954962468723937,5
954500,289,372,417,1078,954500,0.2680890538033395,0.3450834879406308,0.3868274582560297,5
954600,155,182,211,548,954600,0.28284671532846717,0.33211678832116787,0.38503649635036497,5
954700,127,190,232,549,954700,0.23132969034608378,0.3460837887067395,0.4225865209471767,5
954800,474,589,512,1575,954800,0.30095238095238097,0.37396825396825395,0.3250793650793651,3
954900,160,215,207,582,954900,0.27491408934707906,0.3694158075601375,0.3556701030927835,5
955000,496,641,760,1897,955000,0.2614654717975751,0.3379019504480759,0.40063257775434896,5
955300,157,262,283,702,955300,0.22364672364672364,0.3732193732193732,0.4031339031339031,5
955400,309,336,591,1236,955400,0.25,0.27184466019417475,0.47815533980582525,6
960100,839,1236,955,3030,960100,0.2768976897689769,0.4079207920792079,0.31518151815181517,5
960200,1216,1820,1489,4525,960200,0.2687292817679558,0.4022099447513812,0.329060773480663,5
960300,1341,1668,1685,4694,960300,0.2856838517256072,0.35534725181082233,0.3589688964635705,5
960400,1040,1194,1161,3395,960400,0.30633284241531666,0.3516936671575847,0.3419734904270987,3
960498,376,463,433,1272,960498,0.29559748427672955,0.3639937106918239,0.34040880503144655,5
960500,1031,1217,1012,3260,960500,0.31625766871165645,0.37331288343558283,0.3104294478527607,3
960598,766,1038,943,2747,960598,0.27884965416818347,0.3778667637422643,0.34328358208955223,5
960600,982,1094,1044,3120,960600,0.31474358974358974,0.3506410256410256,0.3346153846153846,3
960700,703,904,727,2334,960700,0.30119965724078834,0.3873179091688089,0.31148243359040273,3
960702,491,450,438,1379,960702,0.3560551124002901,0.3263234227701233,0.31762146482958664,3
960800,1247,1632,1267,4146,960800,0.3007718282682103,0.39363241678726485,0.30559575494452484,3
960900,1028,1280,1218,3526,960900,0.29154849688031764,0.3630175836642087,0.34543391945547364,5
961000,1832,2521,2557,6910,961000,0.26512301013024603,0.36483357452966714,0.37004341534008683,5
961100,1294,1829,1881,5004,961100,0.25859312549960034,0.3655075939248601,0.37589928057553956,5
961200,1620,1960,2077,5657,961200,0.2863708679512109,0.34647339579282305,0.36715573625596604,5
961300,1255,1792,1567,4614,961300,0.2719982661465106,0.38838318162115304,0.3396185522323364,5
961400,1048,1306,1135,3489,961400,0.3003725995987389,0.37431928919461166,0.3253081112066495,3
961500,590,749,760,2099,961500,0.281086231538828,0.3568365888518342,0.3620771796093378,5
961600,808,917,964,2689,961600,0.3004834510970621,0.3410189661584232,0.3584975827445147,3
961700,959,1087,1066,3112,961700,0.30816195372750643,0.34929305912596403,0.3425449871465296,3
961800,986,1201,1288,3475,961800,0.2837410071942446,0.3456115107913669,0.37064748201438846,5
961900,467,593,498,1558,961900,0.29974326059050066,0.38061617458279845,0.3196405648267009,5
962000,376,566,501,1443,962000,0.26056826056826055,0.39223839223839224,0.3471933471933472,5
962100,243,419,440,1102,962100,0.22050816696914702,0.38021778584392013,0.3992740471869328,5
962200,612,765,777,2154,962200,0.2841225626740947,0.3551532033426184,0.3607242339832869,5
962300,765,815,1998,3578,962300,0.21380659586361095,0.22778088317495807,0.558412520961431,6
962400,397,467,499,1363,962400,0.29126925898752754,0.34262655906089506,0.3661041819515774,5
962500,323,379,393,1095,962500,0.29497716894977166,0.3461187214611872,0.3589041095890411,5
962600,220,293,445,958,962600,0.22964509394572025,0.3058455114822547,0.46450939457202506,5
962700,351,414,595,1360,962700,0.2580882352941177,0.3044117647058823,0.4375,5
962800,335,512,717,1564,962800,0.21419437340153452,0.3273657289002558,0.4584398976982097,5
962900,283,350,622,1255,962900,0.2254980079681275,0.2788844621513944,0.4956175298804781,6
963000,427,537,714,1678,963000,0.25446960667461266,0.3200238379022646,0.42550655542312277,5
970100,2209,3151,2780,8140,970100,0.27137592137592137,0.3871007371007371,0.3415233415233415,5
970200,2225,3253,2954,8432,970200,0.26387571157495254,0.385792220113852,0.35033206831119545,5
970300,1852,2596,2671,7119,970300,0.2601488973170389,0.36465795757831154,0.3751931451046495,5
970400,2188,2931,3072,8191,970400,0.26712245147112684,0.357831766573068,0.3750457819558052,5
970500,2697,3963,3590,10250,970500,0.2631219512195122,0.3866341463414634,0.35024390243902437,5
970600,2629,3709,3360,9698,970600,0.2710868220251598,0.38244998968859556,0.34646318828624456,5
970601,408,693,606,1707,970601,0.2390158172231986,0.40597539543058,0.35500878734622143,5
970602,597,765,896,2258,970602,0.26439326837909655,0.3387953941541187,0.39681133746678476,5
970700,1975,2539,2284,6798,970700,0.2905266254780818,0.37349220358929097,0.33598117093262725,5
970800,1195,1604,1474,4273,970800,0.2796630002340276,0.37538029487479524,0.34495670489117713,5
970801,653,805,921,2379,970801,0.2744850777637663,0.3383774695250105,0.3871374527112232,5
970802,617,810,932,2359,970802,0.261551504874947,0.3433658329800763,0.39508266214497667,5
970900,1947,2634,2399,6980,970900,0.2789398280802292,0.37736389684813754,0.34369627507163325,5
971000,2064,2816,2967,7847,971000,0.2630304574996814,0.35886325984452655,0.37810628265579205,5
971100,1439,2023,1771,5233,971100,0.27498566787693485,0.3865851328110071,0.3384291993120581,5
971200,1305,1912,1711,4928,971200,0.2648133116883117,0.387987012987013,0.3471996753246753,5
971300,726,1119,941,2786,971300,0.2605886575735822,0.4016511127063891,0.3377602297200287,5
971400,829,1037,965,2831,971400,0.2928293889085129,0.36630166019074534,0.34086895090074176,5
971500,440,714,756,1910,971500,0.23036649214659685,0.3738219895287958,0.3958115183246073,5
980000,22,39,29,90,980000,0.24444444444444444,0.43333333333333335,0.32222222222222224,5
980002,7,16,16,39,980002,0.1794871794871795,0.41025641025641024,0.41025641025641024,5
980003,9,6,4,19,980003,0.47368421052631576,0.3157894736842105,0.21052631578947367,1
980100,75,100,232,407,980100,0.18427518427518427,0.2457002457002457,0.5700245700245701,6
981000,76,131,319,526,981000,0.1444866920152091,0.24904942965779467,0.6064638783269962,6
981100,81,88,199,368,981100,0.22010869565217392,0.2391304347826087,0.5407608695652174,6
982000,85,97,219,401,982000,0.2119700748129676,0.24189526184538654,0.5461346633416458,6
982100,84,100,195,379,982100,0.22163588390501318,0.2638522427440633,0.5145118733509235,6
983000,73,77,183,333,983000,0.21921921921921922,0.23123123123123124,0.5495495495495496,6
984000,62,57,99,218,984000,0.28440366972477066,0.26146788990825687,0.4541284403669725,6
985000,85,89,291,465,985000,0.1827956989247312,0.1913978494623656,0.6258064516129033,6
990000,81,99,106,286,990000,0.28321678321678323,0.34615384615384615,0.3706293706293706,5
990001,11,6,6,23,990001,0.4782608695652174,0.2608695652173913,0.2608695652173913,0
990100,202,238,194,634,990100,0.3186119873817035,0.3753943217665615,0.305993690851735,3
990200,63,42,39,144,990200,0.4375,0.2916666666666667,0.2708333333333333,0
990301,29,31,34,94,990301,0.30851063829787234,0.32978723404255317,0.3617021276595745,3
990302,27,29,35,91,990302,0.2967032967032967,0.31868131868131866,0.38461538461538464,5
990400,34,27,30,91,990400,0.37362637362637363,0.2967032967032967,0.32967032967032966,2
