Census Tract,CE01totcounts,CE02totcounts,CE03totcounts,C000totcounts,ct,CE01Percent,CE02Percent,CE03Percent,TractLabel
000100,3319,3926,8045,15290,000100,0.2170699803793329,0.25676913015042513,0.526160889470242,6
000101,458,801,686,1945,000101,0.23547557840616967,0.41182519280205654,0.3526992287917738,5
000103,608,816,907,2331,000103,0.26083226083226085,0.35006435006435005,0.3891033891033891,5
000104,26,34,26,86,000104,0.3023255813953488,0.3953488372093023,0.3023255813953488,3
000110,366,442,293,1101,000110,0.33242506811989103,0.4014532243415077,0.26612170753860126,1
000200,4028,5531,4382,13941,000200,0.2889319274083638,0.3967434186930636,0.31432465389857256,5
000201,974,1442,1395,3811,000201,0.2555759643138284,0.3783783783783784,0.3660456573077932,5
000202,1032,1330,2107,4469,000202,0.23092414410382636,0.29760572835086146,0.47147012754531215,6
000203,243,382,616,1241,000203,0.19580983078162773,0.30781627719580984,0.49637389202256244,5
000300,3071,4236,4629,11936,000300,0.25728887399463807,0.35489276139410186,0.38781836461126007,5
000301,332,310,1394,2036,000301,0.16306483300589392,0.15225933202357564,0.6846758349705304,6
000400,2499,3526,3609,9634,000400,0.2593938135769151,0.36599543284201785,0.37461075358106705,5
000401,905,1172,1698,3775,000401,0.23973509933774834,0.3104635761589404,0.4498013245033113,5
000402,1182,1572,2396,5150,000402,0.2295145631067961,0.30524271844660195,0.4652427184466019,5
000403,514,684,991,2189,000403,0.23481041571493833,0.3124714481498401,0.45271813613522155,5
000404,178,182,228,588,000404,0.30272108843537415,0.30952380952380953,0.3877551020408163,3
000500,1781,2451,2868,7100,000500,0.25084507042253523,0.3452112676056338,0.40394366197183096,5
000501,1239,1657,2234,5130,000501,0.2415204678362573,0.3230019493177388,0.4354775828460039,5
000502,992,1157,2080,4229,000502,0.2345708205249468,0.27358713643887445,0.4918420430361788,6
000600,5419,7151,7592,20162,000600,0.2687729391925404,0.35467711536553914,0.37654994544192044,5
000700,4877,6045,13013,23935,000700,0.20376018383120953,0.2525590139962398,0.5436808021725507,6
000701,267,443,879,1589,000701,0.16803020767778476,0.27879169288860917,0.5531780994336061,6
000702,375,573,1033,1981,000702,0.18929833417465927,0.28924785461887936,0.5214538112064614,6
000800,3783,4522,4813,13118,000800,0.2883823753620979,0.3447171824973319,0.3669004421405702,5
000801,436,599,1515,2550,000801,0.17098039215686275,0.23490196078431372,0.5941176470588235,6
000802,239,329,556,1124,000802,0.21263345195729538,0.29270462633451955,0.49466192170818507,6
000803,434,564,1030,2028,000803,0.21400394477317555,0.2781065088757396,0.5078895463510849,6
000900,3144,3760,7049,13953,000900,0.22532788647602667,0.2694760983301082,0.5051960151938651,6
001000,3565,4875,4347,12787,001000,0.2787987800109486,0.3812465785563463,0.3399546414327051,5
001001,122,182,500,804,001001,0.1517412935323383,0.2263681592039801,0.6218905472636815,6
001002,656,891,679,2226,001002,0.29469901168014373,0.4002695417789757,0.3050314465408805,5
001100,3159,3897,4878,11934,001100,0.2647058823529412,0.32654600301659126,0.40874811463046756,5
001101,346,459,445,1250,001101,0.2768,0.3672,0.356,5
001102,437,723,877,2037,001102,0.21453117329405988,0.3549337260677467,0.43053510063819345,5
001200,2115,2705,3514,8334,001200,0.25377969762419006,0.3245740340772738,0.42164626829853613,5
001300,2249,2790,5853,10892,001300,0.20648182152038194,0.25615130370914435,0.5373668747704737,6
001301,364,503,825,1692,001301,0.21513002364066194,0.29728132387706857,0.4875886524822695,6
001302,378,536,724,1638,001302,0.23076923076923078,0.32722832722832723,0.442002442002442,5
001303,591,867,904,2362,001303,0.2502116850127011,0.36706181202370874,0.3827265029635902,5
001400,2304,3395,3614,9313,001400,0.24739611296037797,0.36454418554708473,0.3880597014925373,5
001401,593,768,1986,3347,001401,0.17717358828801913,0.2294592172094413,0.5933671945025396,6
001402,950,1120,1554,3624,001402,0.2621412803532009,0.3090507726269316,0.4288079470198676,5
001403,249,371,671,1291,001403,0.19287374128582493,0.28737412858249417,0.5197521301316809,6
001500,3375,4403,6533,14311,001500,0.23583257633987842,0.3076654321850325,0.4565019914750891,5
001501,442,502,2328,3272,001501,0.13508557457212714,0.15342298288508557,0.7114914425427873,6
001502,621,780,4543,5944,001502,0.10447510094212652,0.13122476446837147,0.764300134589502,6
001503,230,279,697,1206,001503,0.19071310116086235,0.23134328358208955,0.5779436152570481,6
001504,419,486,1071,1976,001504,0.21204453441295545,0.24595141700404857,0.542004048582996,6
001505,174,290,537,1001,001505,0.17382617382617382,0.2897102897102897,0.5364635364635365,6
001600,4986,6274,7629,18889,001600,0.2639631531579226,0.3321509873471333,0.40388585949494415,5
001700,2620,3475,4652,10747,001700,0.2437889643621476,0.323346050060482,0.4328649855773704,5
001701,344,476,246,1066,001701,0.3227016885553471,0.44652908067542213,0.23076923076923078,1
001702,308,484,390,1182,001702,0.26057529610829105,0.40947546531302875,0.3299492385786802,5
001800,3869,5520,5884,15273,001800,0.25332285732992865,0.36142211746218816,0.3852550252078832,5
001801,763,873,1927,3563,001801,0.21414538310412573,0.2450182430536065,0.5408363738422678,6
001802,445,592,908,1945,001802,0.22879177377892032,0.3043701799485861,0.4668380462724936,5
001900,2763,3882,5654,12299,001900,0.22465241076510287,0.315635417513619,0.45971217172127815,5
001901,262,362,781,1405,001901,0.18647686832740212,0.2576512455516014,0.5558718861209965,6
001902,279,393,799,1471,001902,0.18966689326988442,0.2671651937457512,0.5431679129843644,6
002000,4271,6217,6185,16673,002000,0.2561626581898878,0.37287830624362744,0.37095903556648474,5
002001,255,357,728,1340,002001,0.19029850746268656,0.2664179104477612,0.5432835820895522,6
002002,297,402,692,1391,002002,0.2135154565061107,0.289000718907261,0.4974838245866283,6
002100,2697,3641,7788,14126,002100,0.19092453631601303,0.25775166359903723,0.5513238000849497,6
002101,684,898,1158,2740,002101,0.24963503649635035,0.3277372262773723,0.4226277372262774,5
002103,279,285,863,1427,002103,0.19551506657323056,0.1997196916608269,0.6047652417659425,6
002104,429,532,1375,2336,002104,0.1836472602739726,0.22773972602739725,0.5886130136986302,6
002105,158,189,484,831,002105,0.1901323706377858,0.22743682310469315,0.5824308062575211,6
002106,277,398,683,1358,002106,0.20397643593519882,0.2930780559646539,0.5029455081001473,6
002107,174,211,484,869,002107,0.2002301495972382,0.2428078250863061,0.5569620253164557,6
002200,2271,3213,3178,8662,002200,0.2621796351881783,0.37093050103902103,0.36688986377280075,5
002201,885,1168,1981,4034,002201,0.21938522558254833,0.28953891918691127,0.4910758552305404,6
002202,655,639,1973,3267,002202,0.2004897459442914,0.19559228650137742,0.6039179675543311,6
002203,166,209,487,862,002203,0.1925754060324826,0.24245939675174014,0.5649651972157773,6
002204,298,452,1224,1974,002204,0.15096251266464034,0.22897669706180346,0.6200607902735562,6
002300,3542,4784,4321,12647,002300,0.28006641891357636,0.3782715268443109,0.34166205424211277,5
002400,1985,2666,1950,6601,002400,0.3007120133313134,0.40387820027268595,0.29540978639600063,1
002401,152,203,430,785,002401,0.19363057324840766,0.2585987261146497,0.5477707006369427,6
002402,298,380,903,1581,002402,0.18848829854522453,0.24035420619860848,0.571157495256167,6
002403,457,672,1228,2357,002403,0.19389053882053459,0.28510818837505303,0.5210012728044124,6
002404,227,357,621,1205,002404,0.1883817427385892,0.2962655601659751,0.5153526970954356,6
002405,259,357,670,1286,002405,0.20139968895800933,0.2776049766718507,0.52099533437014,6
002500,2289,3131,1891,7311,002500,0.31308986458760774,0.42825878812747914,0.2586513472849131,1
002502,266,290,211,767,002502,0.3468057366362451,0.37809647979139505,0.27509778357235987,1
002600,1301,1825,1675,4801,002600,0.27098521141428866,0.3801291397625495,0.34888564882316186,5
002601,405,500,873,1778,002601,0.22778402699662542,0.281214848143982,0.49100112485939257,6
002602,497,484,1272,2253,002602,0.2205947625388371,0.21482467820683532,0.5645805592543276,6
002700,1131,1439,1640,4210,002700,0.268646080760095,0.34180522565320665,0.38954869358669836,5
002701,362,498,264,1124,002701,0.3220640569395018,0.4430604982206406,0.23487544483985764,1
002702,671,928,410,2009,002702,0.33399701343952215,0.4619213539074166,0.20408163265306123,1
002800,2005,2912,3809,8726,002800,0.22977309190923675,0.3337153334861334,0.43651157460462986,5
002900,2431,3097,2967,8495,002900,0.28616833431430255,0.3645673925838729,0.3492642731018246,5
002901,771,1005,876,2652,002901,0.2907239819004525,0.37895927601809953,0.33031674208144796,5
003000,1511,1996,1750,5257,003000,0.2874262887578467,0.3796842305497432,0.33288948069241014,5
003001,438,551,1700,2689,003001,0.1628858311640015,0.20490888806247676,0.6322052807735218,6
003002,270,338,1127,1735,003002,0.15561959654178675,0.19481268011527378,0.6495677233429394,6
003100,1935,2653,3867,8455,003100,0.22885866351271436,0.31377882909520993,0.4573625073920757,5
003200,1688,2127,4357,8172,003200,0.20655898188937835,0.2602790014684288,0.5331620166421929,6
003300,2193,2881,6347,11421,003300,0.1920147097452062,0.25225461868487875,0.5557306715699151,6
003301,389,493,210,1092,003301,0.35622710622710624,0.45146520146520147,0.19230769230769232,1
003302,371,418,167,956,003302,0.3880753138075314,0.4372384937238494,0.17468619246861924,1
003400,2588,3088,5371,11047,003400,0.23427174798587852,0.27953290486104826,0.4861953471530732,6
003500,1806,2177,2096,6079,003500,0.297088336897516,0.3581181115315019,0.34479355157098207,5
003600,1981,2755,3719,8455,003600,0.23429923122412774,0.3258426966292135,0.4398580721466588,5
003601,734,821,1160,2715,003601,0.2703499079189687,0.3023941068139963,0.427255985267035,5
003602,605,679,1327,2611,003602,0.23171198774415933,0.26005361930294907,0.5082343929528916,6
003700,1772,2137,3532,7441,003700,0.23814003494154012,0.28719258164225236,0.4746673834162075,6
003800,2295,2765,5542,10602,003800,0.2164685908319185,0.2607998490850783,0.5227315600830033,6
003802,190,69,55,314,003802,0.6050955414012739,0.2197452229299363,0.1751592356687898,0
003805,670,1031,907,2608,003805,0.25690184049079756,0.3953220858895706,0.3477760736196319,5
003900,2554,3219,5633,11406,003900,0.2239172365421708,0.2822198842714361,0.4938628791863931,6
003901,155,159,82,396,003901,0.39141414141414144,0.4015151515151515,0.20707070707070707,1
004000,3152,4006,6628,13786,004000,0.22863774844044682,0.29058465109531406,0.48077760046423906,6
004001,924,1294,931,3149,004001,0.2934264845982852,0.4109241028898063,0.2956494125119085,4
004002,162,252,239,653,004002,0.24808575803981622,0.38591117917304746,0.3660030627871363,5
004100,2819,3390,4900,11109,004100,0.2537582140606715,0.3051579800162031,0.4410838059231254,5
004200,2614,3331,4366,10311,004200,0.25351566288429833,0.3230530501406265,0.42343128697507515,5
004300,2367,3086,4768,10221,004300,0.2315820369826827,0.3019274043635652,0.46649055865375205,5
004301,104,135,64,303,004301,0.3432343234323432,0.44554455445544555,0.21122112211221122,1
004302,313,238,228,779,004302,0.4017971758664955,0.3055198973042362,0.2926829268292683,1
004400,2253,2477,8358,13088,004400,0.1721424205378973,0.1892573349633252,0.6386002444987775,6
004401,966,1357,981,3304,004401,0.2923728813559322,0.4107142857142857,0.2969128329297821,4
004402,376,435,96,907,004402,0.4145534729878721,0.4796030871003308,0.10584343991179714,1
004500,2167,2196,4652,9015,004500,0.2403771491957848,0.24359400998336106,0.5160288408208541,6
004600,980,1198,2170,4348,004600,0.22539098436062557,0.2755289788408464,0.4990800367985281,6
004601,470,462,542,1474,004601,0.31886024423337855,0.31343283582089554,0.3677069199457259,3
004602,299,390,159,848,004602,0.35259433962264153,0.45990566037735847,0.1875,1
004700,2110,2513,4426,9049,004700,0.23317493645706708,0.2777102442258813,0.4891148193170516,6
004701,395,470,301,1166,004701,0.33876500857632935,0.40308747855917665,0.258147512864494,1
004702,279,406,191,876,004702,0.3184931506849315,0.4634703196347032,0.2180365296803653,1
004800,2253,2643,6079,10975,004800,0.20528473804100228,0.24082004555808656,0.5538952164009112,6
004900,1832,2100,4807,8739,004900,0.20963496967616432,0.2403020940611054,0.5500629362627303,6
005000,1749,2153,5006,8908,005000,0.19634036820835205,0.24169286035024698,0.561966771441401,6
005001,651,993,1522,3166,005001,0.20562223626026532,0.3136449778900821,0.48073278584965257,5
005002,837,1156,1896,3889,005002,0.2152224222165081,0.2972486500385703,0.48752892774492157,6
005100,2544,3371,3937,9852,005100,0.2582216808769793,0.34216402760860737,0.3996142915144133,5
005200,1851,1957,3657,7465,005200,0.24795713328868052,0.2621567314132619,0.4898861352980576,6
005201,467,577,1063,2107,005201,0.2216421452301851,0.27384907451352636,0.5045087802562885,6
005202,487,511,1083,2081,005202,0.2340221047573282,0.24555502162421913,0.5204228736184526,6
005300,2266,2741,4053,9060,005300,0.2501103752759382,0.3025386313465784,0.44735099337748346,5
005400,2972,3985,6465,13422,005400,0.22142750707793174,0.29690061093726716,0.4816718819848011,6
005500,1667,2079,2308,6054,005500,0.2753551370994384,0.3434093161546085,0.3812355467459531,5
005501,218,254,1559,2031,005501,0.10733628754308222,0.12506154603643527,0.7676021664204825,6
005502,187,185,940,1312,005502,0.14253048780487804,0.1410060975609756,0.7164634146341463,6
005600,1365,1776,2352,5493,005600,0.2484980884762425,0.3233205898416166,0.4281813216821409,5
005601,462,476,1177,2115,005601,0.21843971631205675,0.22505910165484633,0.556501182033097,6
005602,323,257,649,1229,005602,0.2628152969894223,0.20911310008136696,0.5280716029292107,6
005700,1458,1902,2962,6322,005700,0.23062322049984182,0.30085416007592536,0.46852261942423284,5
005701,523,613,1629,2765,005701,0.1891500904159132,0.2216998191681736,0.5891500904159132,6
005702,283,310,781,1374,005702,0.2059679767103348,0.22561863173216884,0.5684133915574964,6
005800,2205,2827,5177,10209,005800,0.21598589479870703,0.2769125281614262,0.5071015770398668,6
005801,392,506,285,1183,005801,0.33136094674556216,0.42772612003381233,0.24091293322062554,1
005802,618,704,343,1665,005802,0.37117117117117115,0.4228228228228228,0.206006006006006,1
005900,2164,2575,4789,9528,005900,0.227120067170445,0.2702560873215785,0.5026238455079765,6
005901,474,533,937,1944,005901,0.24382716049382716,0.2741769547325103,0.48199588477366256,6
005902,720,1124,1921,3765,005902,0.19123505976095617,0.29853917662682605,0.5102257636122178,6
006000,2000,2631,4623,9254,006000,0.2161227577263886,0.2843094877890642,0.4995677544845472,6
006100,2490,3147,6123,11760,006100,0.21173469387755103,0.26760204081632655,0.5206632653061225,6
006101,509,598,321,1428,006101,0.35644257703081234,0.41876750700280113,0.22478991596638656,1
006102,243,256,231,730,006102,0.33287671232876714,0.3506849315068493,0.31643835616438354,3
006103,326,439,474,1239,006103,0.26311541565778856,0.354317998385795,0.38256658595641646,5
006200,2010,2807,3623,8440,006200,0.2381516587677725,0.33258293838862557,0.4292654028436019,5
006201,479,634,1251,2364,006201,0.20262267343485618,0.26818950930626057,0.5291878172588832,6
006202,403,645,1057,2105,006202,0.19144893111638955,0.30641330166270786,0.5021377672209026,5
006300,2934,3569,7247,13750,006300,0.21338181818181817,0.2595636363636364,0.5270545454545454,6
006301,516,663,596,1775,006301,0.29070422535211266,0.37352112676056337,0.3357746478873239,5
006302,255,257,583,1095,006302,0.2328767123287671,0.23470319634703196,0.5324200913242009,6
006400,2409,3081,6765,12255,006400,0.19657282741738066,0.2514075887392901,0.5520195838433293,6
006500,2102,2553,5966,10621,006500,0.19790980133697392,0.24037284624799923,0.5617173524150268,6
006501,739,960,1726,3425,006501,0.21576642335766424,0.28029197080291973,0.503941605839416,6
006502,359,497,1271,2127,006502,0.16878232251998118,0.23366243535496004,0.5975552421250587,6
006600,1976,2322,6629,10927,006600,0.18083646014459595,0.21250114395533998,0.6066623959000641,6
006601,324,359,302,985,006601,0.32893401015228424,0.36446700507614216,0.3065989847715736,3
006602,222,262,451,935,006602,0.2374331550802139,0.2802139037433155,0.4823529411764706,6
006700,2383,2920,6742,12045,006700,0.19784142797841428,0.24242424242424243,0.5597343295973433,6
006701,378,479,476,1333,006701,0.2835708927231808,0.35933983495873967,0.3570892723180795,5
006702,390,526,740,1656,006702,0.23550724637681159,0.3176328502415459,0.4468599033816425,5
006800,2176,2732,4964,9872,006800,0.22042139384116693,0.276742301458671,0.502836304700162,6
006801,454,458,1578,2490,006801,0.1823293172690763,0.18393574297188756,0.6337349397590362,6
006802,387,442,1550,2379,006802,0.1626733921815889,0.18579234972677597,0.6515342580916351,6
006900,2339,2971,5920,11230,006900,0.2082813891362422,0.2645592163846839,0.5271593944790739,6
006901,387,525,150,1062,006901,0.3644067796610169,0.4943502824858757,0.14124293785310735,1
006902,450,571,331,1352,006902,0.3328402366863905,0.4223372781065089,0.2448224852071006,1
007000,3000,3719,8592,15311,007000,0.1959375612304879,0.2428972634053948,0.5611651753641173,6
007100,2297,2832,6591,11720,007100,0.19598976109215016,0.2416382252559727,0.5623720136518772,6
007101,430,437,161,1028,007101,0.4182879377431907,0.42509727626459143,0.1566147859922179,1
007102,347,397,189,933,007102,0.37191854233654875,0.4255091103965702,0.20257234726688103,1
007200,1591,2143,6345,10079,007200,0.15785296160333367,0.21262029963290008,0.6295267387637662,6
007202,239,337,293,869,007202,0.27502876869965476,0.3878020713463751,0.33716915995397007,5
007300,1707,2072,5502,9281,007300,0.1839241461049456,0.22325180476241785,0.5928240491326365,6
007302,977,1200,1911,4088,007302,0.2389921722113503,0.29354207436399216,0.4674657534246575,6
007303,904,1049,1566,3519,007303,0.25689116226200626,0.2980960500142086,0.44501278772378516,6
007304,648,675,1399,2722,007304,0.23806024981631155,0.24797942689199118,0.5139603232916973,6
007400,1500,1968,3837,7305,007400,0.2053388090349076,0.2694045174537988,0.5252566735112937,6
007401,336,427,1176,1939,007401,0.17328519855595667,0.22021660649819494,0.6064981949458483,6
007402,206,185,814,1205,007402,0.17095435684647303,0.15352697095435686,0.6755186721991702,6
007500,2595,3187,6976,12758,007500,0.2034017871139677,0.24980404452108482,0.5467941683649474,6
007600,2391,2992,5078,10461,007600,0.22856323487238314,0.28601472134595163,0.48542204378166526,6
007700,2671,3253,7822,13746,007700,0.1943110723119453,0.23665066201076676,0.569038265677288,6
007800,2533,3642,6651,12826,007800,0.1974894745049119,0.2839544674879152,0.518556058007173,6
007801,288,359,582,1229,007801,0.23433685923515052,0.2921074043938161,0.4735557363710334,6
007802,195,181,487,863,007802,0.22595596755504055,0.20973348783314022,0.5643105446118193,6
007900,2167,2994,4562,9723,007900,0.2228735986835339,0.30792965134217837,0.4691967499742878,5
007901,454,582,788,1824,007901,0.24890350877192982,0.3190789473684211,0.43201754385964913,5
007902,826,1035,1332,3193,007902,0.2586908863138115,0.3241465706232383,0.4171625430629502,5
007903,528,543,810,1881,007903,0.2807017543859649,0.2886762360446571,0.430622009569378,6
007904,468,545,774,1787,007904,0.26189143816452154,0.3049804141018467,0.4331281477336318,5
007905,628,765,1033,2426,007905,0.2588623248145095,0.31533388293487224,0.4258037922506183,5
008000,1289,1790,3719,6798,008000,0.18961459252721388,0.26331273904089436,0.5470726684318917,6
008001,828,934,1040,2802,008001,0.2955032119914347,0.3333333333333333,0.371163454675232,5
008002,827,925,1283,3035,008002,0.27248764415156507,0.30477759472817134,0.4227347611202636,5
008003,779,990,988,2757,008003,0.28255350018135655,0.3590859630032644,0.35836053681537905,5
008100,1962,2550,5757,10269,008100,0.19106047326906223,0.2483201869704937,0.5606193397604441,6
008101,758,904,1201,2863,008101,0.2647572476423332,0.31575270695075097,0.4194900454069158,5
008102,651,723,1145,2519,008102,0.25843588725684796,0.2870186581976975,0.45454545454545453,6
008200,1648,2235,4455,8338,008200,0.19764931638282562,0.26804989206044616,0.5343007915567283,6
008201,364,483,514,1361,008201,0.2674504041146216,0.35488611315209406,0.3776634827332844,5
008202,414,588,692,1694,008202,0.24439197166469895,0.34710743801652894,0.4085005903187721,5
008300,1735,2453,2822,7010,008300,0.24750356633380885,0.3499286733238231,0.402567760342368,5
008301,781,1153,1112,3046,008301,0.25640183847669074,0.37852921864740646,0.3650689428759028,5
008302,408,467,1818,2693,008302,0.15150389899740066,0.1734125510582993,0.6750835499443001,6
008400,1428,1965,2273,5666,008400,0.2520296505471232,0.34680550653018,0.4011648429226968,5
008401,136,165,547,848,008401,0.16037735849056603,0.1945754716981132,0.6450471698113207,6
008403,259,295,897,1451,008403,0.17849758787043418,0.2033080634045486,0.6181943487250172,6
008404,355,406,1252,2013,008404,0.17635370094386488,0.20168902136115252,0.6219572776949827,6
008500,2448,3354,3272,9074,008500,0.269781794137095,0.36962750716332377,0.3605906986995812,5
008600,1968,2561,3051,7580,008600,0.2596306068601583,0.33786279683377307,0.4025065963060686,5
008601,119,192,1162,1473,008601,0.08078750848608282,0.13034623217922606,0.7888662593346911,6
008602,385,361,1381,2127,008602,0.18100611189468735,0.16972261401034322,0.6492712740949694,6
008603,226,254,1531,2011,008603,0.11238189955246146,0.12630532073595227,0.7613127797115863,6
008700,2429,3374,6351,12154,008700,0.19985190060885305,0.2776040809610005,0.5225440184301464,6
008701,480,780,402,1662,008701,0.2888086642599278,0.4693140794223827,0.24187725631768953,4
008702,221,289,141,651,008702,0.33947772657450076,0.44393241167434716,0.21658986175115208,1
008800,2305,2988,6508,11801,008800,0.19532243030251673,0.2531988814507245,0.5514786882467587,6
008900,1349,1561,3516,6426,008900,0.20992841581076876,0.2429193899782135,0.5471521942110178,6
008901,514,604,1697,2815,008901,0.18259325044404973,0.21456483126110124,0.602841918294849,6
008902,382,449,1056,1887,008902,0.20243773184949657,0.2379438261791203,0.5596184419713831,6
009000,1482,1917,5156,8555,009000,0.17323202805376972,0.22407948568088837,0.6026884862653419,6
009004,419,481,977,1877,009004,0.22322855620671284,0.256259989344699,0.5205114544485882,6
009006,833,872,1988,3693,009006,0.2255618738153263,0.23612239371784458,0.5383157324668292,6
009007,930,755,2020,3705,009007,0.25101214574898784,0.203778677462888,0.5452091767881242,6
009008,452,395,1095,1942,009008,0.23274974253347064,0.20339855818743563,0.5638516992790937,6
009009,566,530,1407,2503,009009,0.2261286456252497,0.21174590491410308,0.5621254494606472,6
009010,703,703,1549,2955,009010,0.23790186125211507,0.23790186125211507,0.5241962774957699,6
009100,1386,1471,4864,7721,009100,0.17951042611060744,0.19051936277684237,0.6299702111125501,6
009104,523,501,1060,2084,009104,0.2509596928982726,0.24040307101727448,0.508637236084453,6
009106,419,438,703,1560,009106,0.2685897435897436,0.28076923076923077,0.45064102564102565,6
009107,730,703,914,2347,009107,0.31103536429484446,0.2995313165743502,0.3894333191308053,2
009109,504,451,724,1679,009109,0.3001786777843955,0.2686122692078618,0.4312090530077427,2
009110,150,125,206,481,009110,0.31185031185031187,0.2598752598752599,0.4282744282744283,2
009112,348,318,414,1080,009112,0.32222222222222224,0.29444444444444445,0.38333333333333336,2
009113,860,731,1786,3377,009113,0.25466390287237195,0.21646431744151615,0.528871779686112,6
009114,618,519,1024,2161,009114,0.2859787135585377,0.24016658954187875,0.47385469689958354,6
009115,357,427,457,1241,009115,0.2876712328767123,0.3440773569701853,0.3682514101531023,5
009116,701,649,1068,2418,009116,0.28990901571546734,0.2684036393713813,0.44168734491315137,6
009200,2593,3368,5154,11115,009200,0.23328834907782275,0.30301394511920826,0.463697705802969,5
009300,1599,2052,4258,7909,009300,0.20217473764066254,0.25945125806043745,0.5383740042989,6
009301,1010,1262,865,3137,009301,0.32196365954733824,0.40229518648390183,0.27574115396876,1
009302,653,913,870,2436,009302,0.2680623973727422,0.37479474548440067,0.35714285714285715,5
009400,2134,2255,3030,7419,009400,0.287639843644696,0.3039493193152716,0.40841083704003234,5
009401,646,723,1263,2632,009401,0.2454407294832827,0.27469604863221886,0.4798632218844985,6
009402,513,509,1151,2173,009402,0.23607915324436263,0.23423838011965026,0.5296824666359871,6
009500,1494,1651,3871,7016,009500,0.2129418472063854,0.23531927023945268,0.5517388825541619,6
009501,594,619,1360,2573,009501,0.2308589195491644,0.24057520404197436,0.5285658764088612,6
009502,859,857,1717,3433,009502,0.250218467812409,0.24963588697931838,0.5001456452082726,6
009600,2293,2838,4818,9949,009600,0.23047542466579557,0.2852547994773344,0.48426977585687003,6
009601,570,721,982,2273,009601,0.2507699076110867,0.3172019357677079,0.4320281566212055,5
009602,508,646,805,1959,009602,0.259315977539561,0.32976008167432364,0.4109239407861154,5
009603,274,321,92,687,009603,0.3988355167394469,0.4672489082969432,0.1339155749636099,1
009604,147,182,58,387,009604,0.3798449612403101,0.4702842377260982,0.14987080103359174,1
009700,1294,1546,3242,6082,009700,0.21275896086813548,0.25419269976981257,0.533048339362052,6
009701,674,831,1574,3079,009701,0.21890224098733355,0.2698928223449172,0.5112049366677492,6
009702,890,1012,1891,3793,009702,0.23464276298444503,0.2668072765620881,0.4985499604534669,6
009703,335,323,1257,1915,009703,0.17493472584856398,0.16866840731070495,0.6563968668407311,6
009800,2198,3044,6209,11451,009800,0.19194830145838793,0.265828311937822,0.5422233866037901,6
009900,1111,1376,3600,6087,009900,0.18252012485625102,0.22605552817479876,0.5914243469689502,6
010000,1869,2290,4095,8254,010000,0.2264356675551248,0.27744124061061304,0.4961230918342622,6
010001,384,562,564,1510,010001,0.2543046357615894,0.37218543046357616,0.37350993377483444,5
010002,575,706,676,1957,010002,0.29381706693919263,0.36075625958099133,0.34542667347981604,5
010003,537,757,752,2046,010003,0.2624633431085044,0.3699902248289345,0.3675464320625611,5
010100,3324,4602,7676,15602,010100,0.21304960902448403,0.2949621843353416,0.49198820664017434,6
010101,1870,2251,3716,7837,010101,0.2386117136659436,0.2872272553272936,0.47416103100676277,6
010102,1736,2116,2874,6726,010102,0.25810288432946776,0.3146000594707107,0.4272970561998216,5
010103,560,733,891,2184,010103,0.2564102564102564,0.3356227106227106,0.40796703296703296,5
010200,5454,6563,10885,22902,010200,0.23814514016243124,0.2865688586149681,0.4752860012226007,6
010201,850,1131,1238,3219,010201,0.26405716060888473,0.35135135135135137,0.3845914880397639,5
010202,1004,1252,1321,3577,010202,0.28068213586804586,0.3500139781940173,0.36930388593793684,5
010300,3933,4719,9104,17756,010300,0.22150259067357514,0.2657693174138319,0.5127280919125929,6
010301,599,728,1316,2643,010301,0.2266363980325388,0.2754445705637533,0.4979190314037079,6
010321,377,373,835,1585,010321,0.23785488958990536,0.23533123028391167,0.526813880126183,6
010322,491,524,1017,2032,010322,0.24163385826771652,0.2578740157480315,0.500492125984252,6
010400,4505,5606,7696,17807,010400,0.2529903970348739,0.3148200146009996,0.43218958836412646,5
010500,4466,5241,9634,19341,010500,0.23090843286283025,0.27097874980611136,0.4981128173310584,6
010501,852,1115,1655,3622,010501,0.23522915516289342,0.30784097183876313,0.4569298729983435,5
010502,908,1139,1951,3998,010502,0.2271135567783892,0.28489244622311155,0.48799399699849927,6
010503,224,267,526,1017,010503,0.22025565388397247,0.26253687315634217,0.5172074729596854,6
010600,3681,4350,6446,14477,010600,0.25426538647509844,0.30047661808385717,0.44525799544104444,5
010601,1168,1431,3567,6166,010601,0.1894258838793383,0.23207914369120985,0.5784949724294518,6
010602,1595,1934,4009,7538,010602,0.2115945874237198,0.2565667285752189,0.5318386840010613,6
010700,2855,3733,5301,11889,010700,0.24013794263605012,0.313987719740937,0.4458743376230129,5
010701,1170,1474,2812,5456,010701,0.21444281524926687,0.2701612903225806,0.5153958944281525,6
010702,1109,1437,2373,4919,010702,0.22545232770888393,0.2921325472657044,0.4824151250254117,6
010703,401,607,529,1537,010703,0.2608978529603123,0.394925178919974,0.3441769681197137,5
010800,3054,3957,7310,14321,010800,0.213253264436841,0.27630752042455137,0.5104392151386077,6
010801,1116,1315,3010,5441,010801,0.2051093548979967,0.24168351405991545,0.5532071310420879,6
010802,1083,1090,2729,4902,010802,0.22093023255813954,0.22235822113423093,0.5567115463076295,6
010803,1216,1291,3077,5584,010803,0.2177650429799427,0.23119627507163323,0.5510386819484241,6
010804,1154,1304,2827,5285,010804,0.2183538315988647,0.2467360454115421,0.5349101229895932,6
010805,714,894,1216,2824,010805,0.2528328611898017,0.31657223796033995,0.43059490084985835,5
010807,769,842,889,2500,010807,0.3076,0.3368,0.3556,3
010808,519,737,905,2161,010808,0.24016658954187875,0.34104581212401663,0.41878759833410456,5
010809,464,614,857,1935,010809,0.23979328165374678,0.317312661498708,0.44289405684754524,5
010900,2107,2448,4647,9202,010900,0.22897196261682243,0.26602912410345575,0.5049989132797218,6
010901,2062,2385,3897,8344,010901,0.2471236816874401,0.28583413231064236,0.46704218600191755,6
010902,2643,3298,5728,11669,010902,0.22649755763133086,0.2826291884480247,0.49087325392064446,6
010903,554,636,1254,2444,010903,0.22667757774140754,0.2602291325695581,0.5130932896890343,6
011000,3806,4816,9147,17769,011000,0.21419325792109853,0.2710338229500816,0.5147729191288198,6
011001,202,374,295,871,011001,0.23191733639494833,0.4293915040183697,0.338691159586682,5
011002,279,491,448,1218,011002,0.229064039408867,0.40311986863711,0.367816091954023,5
011011,364,508,868,1740,011011,0.20919540229885059,0.29195402298850576,0.49885057471264366,6
011012,452,646,948,2046,011012,0.2209188660801564,0.31573802541544477,0.4633431085043988,5
011021,425,374,781,1580,011021,0.2689873417721519,0.23670886075949368,0.49430379746835446,6
011022,401,543,678,1622,011022,0.24722564734895192,0.3347718865598027,0.41800246609124536,5
011100,3145,4016,6976,14137,011100,0.22246586970361462,0.28407724411119756,0.4934568861851878,6
011101,2049,2329,5258,9636,011101,0.21264009962640099,0.241697799916978,0.545662100456621,6
011102,1885,2483,4228,8596,011102,0.21928804094927873,0.2888552815262913,0.49185667752442996,6
011200,5212,6105,9795,21112,011200,0.24687381583933307,0.28917203486169,0.4639541492989769,6
011201,1578,1959,3474,7011,011201,0.22507488232777065,0.27941805733846814,0.49550706033376124,6
011202,1176,1373,2904,5453,011202,0.21566110397946084,0.2517880066018705,0.5325508894186686,6
011203,366,433,1147,1946,011203,0.1880781089414183,0.2225077081192189,0.5894141829393628,6
011205,675,640,1518,2833,011205,0.23826332509707024,0.22590893046240734,0.5358277444405224,6
011207,615,742,1205,2562,011207,0.24004683840749413,0.2896174863387978,0.47033567525370806,6
011208,606,709,1100,2415,011208,0.25093167701863356,0.29358178053830225,0.4554865424430642,6
011231,541,700,1129,2370,011231,0.22827004219409283,0.29535864978902954,0.47637130801687766,6
011232,485,531,1070,2086,011232,0.23250239693192715,0.2545541706615532,0.5129434324065196,6
011241,237,239,655,1131,011241,0.20954907161803712,0.21131741821396993,0.579133510167993,6
011242,733,927,1439,3099,011242,0.23652791222975153,0.29912875121006777,0.46434333656018073,6
011300,3146,3953,7322,14421,011300,0.21815408085430968,0.27411413910269744,0.5077317800429929,6
011301,2072,2312,4157,8541,011301,0.24259454396440697,0.27069429809155837,0.48671115794403463,6
011302,1629,1886,3682,7197,011302,0.22634431012922052,0.26205363345838545,0.5116020564123941,6
011303,583,604,1678,2865,011303,0.20349040139616056,0.21082024432809773,0.5856893542757418,6
011400,3843,4515,7824,16182,011400,0.2374860956618465,0.27901371894697813,0.4835001853911754,6
011401,1596,1784,3835,7215,011401,0.22120582120582122,0.24726264726264727,0.5315315315315315,6
011402,946,1195,2658,4799,011402,0.19712440091685768,0.2490102104605126,0.5538653886226297,6
011403,614,558,1553,2725,011403,0.22532110091743118,0.20477064220183486,0.569908256880734,6
011404,395,527,1128,2050,011404,0.1926829268292683,0.2570731707317073,0.5502439024390244,6
011405,467,616,1129,2212,011405,0.21112115732368897,0.27848101265822783,0.5103978300180831,6
011500,3237,3737,8357,15331,011500,0.21114082577783574,0.24375448437805752,0.5451046898441068,6
011501,1822,2004,3611,7437,011501,0.24499125991663306,0.26946349334409037,0.48554524673927657,6
011502,1402,1841,2024,5267,011502,0.26618568445035123,0.349534839567116,0.38427947598253276,5
011503,680,665,1527,2872,011503,0.23676880222841226,0.23154596100278552,0.5316852367688022,6
011504,1612,2114,3315,7041,011504,0.22894475216588553,0.3002414429768499,0.4708138048572646,5
011505,1135,1009,1981,4125,011505,0.27515151515151515,0.2446060606060606,0.48024242424242425,6
011506,524,425,490,1439,011506,0.36414176511466295,0.2953439888811675,0.3405142460041696,2
011600,3221,3949,6688,13858,011600,0.2324289219223553,0.2849617549429932,0.4826093231346515,6
011601,1469,1712,2888,6069,011601,0.24204976108090295,0.2820893063107596,0.47586093260833745,6
011602,889,1031,1956,3876,011602,0.22936016511867904,0.2659958720330237,0.5046439628482973,6
011603,809,869,1517,3195,011603,0.25320813771517997,0.27198748043818466,0.47480438184663537,6
011604,286,283,577,1146,011604,0.24956369982547993,0.2469458987783595,0.5034904013961605,6
011605,291,279,560,1130,011605,0.2575221238938053,0.24690265486725663,0.49557522123893805,6
011700,3181,3737,8354,15272,011700,0.20828968046097432,0.24469617600838134,0.5470141435306444,6
011701,474,652,1122,2248,011701,0.21085409252669038,0.2900355871886121,0.4991103202846975,6
011702,456,503,882,1841,011702,0.24769147202607278,0.27322107550244434,0.4790874524714829,6
011703,975,990,2354,4319,011703,0.2257467006251447,0.22921972678860847,0.5450335725862469,6
011705,636,636,1327,2599,011705,0.24470950365525201,0.24470950365525201,0.510580992689496,6
011706,560,464,1311,2335,011706,0.2398286937901499,0.1987152034261242,0.5614561027837259,6
011707,836,798,1918,3552,011707,0.23536036036036037,0.22466216216216217,0.5399774774774775,6
011708,391,330,928,1649,011708,0.23711340206185566,0.20012128562765313,0.5627653123104912,6
011800,4741,5420,12125,22286,011800,0.21273445212240868,0.24320201023063806,0.5440635376469533,6
011801,524,628,989,2141,011801,0.24474544605324614,0.2933208780943484,0.4619336758524054,6
011802,319,360,628,1307,011802,0.24407039020657995,0.2754399387911247,0.48048967100229534,6
011900,2828,3549,5470,11847,011900,0.23871022199713007,0.2995695112686756,0.4617202667341943,6
011901,1391,1581,2568,5540,011901,0.25108303249097474,0.28537906137184116,0.4635379061371841,6
011902,1688,1913,4142,7743,011902,0.21800335787162597,0.24706186232726332,0.5349347798011107,6
011903,258,477,405,1140,011903,0.22631578947368422,0.41842105263157897,0.35526315789473684,5
012000,2751,3233,6014,11998,012000,0.22928821470245042,0.26946157692948824,0.5012502083680613,6
012001,610,779,1107,2496,012001,0.24439102564102563,0.312099358974359,0.44350961538461536,5
012002,535,539,952,2026,012002,0.2640671273445212,0.2660414610069102,0.4698914116485686,6
012003,759,789,1276,2824,012003,0.2687677053824363,0.27939093484419264,0.4518413597733711,6
012100,3724,3560,7804,15088,012100,0.2468186638388123,0.235949098621421,0.5172322375397667,6
012101,1647,2079,3505,7231,012101,0.22776932651085605,0.28751210067763794,0.48471857281150604,6
012102,1949,2004,3128,7081,012102,0.2752436096596526,0.28301087417031495,0.4417455161700325,6
012103,971,1105,1319,3395,012103,0.2860088365243004,0.32547864506627394,0.38851251840942563,5
012105,548,497,490,1535,012105,0.35700325732899024,0.3237785016286645,0.31921824104234525,3
012106,437,517,548,1502,012106,0.29094540612516645,0.34420772303595204,0.3648468708388815,5
012200,2474,2942,5811,11227,012200,0.2203616282176895,0.2620468513405184,0.5175915204417921,6
012201,780,845,1445,3070,012201,0.254071661237785,0.2752442996742671,0.47068403908794787,6
012202,1467,2236,2558,6261,012202,0.23430761859127935,0.3571314486503753,0.4085609327583453,5
012203,358,457,490,1305,012203,0.2743295019157088,0.35019157088122604,0.37547892720306514,5
012204,383,371,448,1202,012204,0.31863560732113144,0.3086522462562396,0.37271214642262895,3
012300,2889,3904,4140,10933,012300,0.2642458611543035,0.35708405744077565,0.37867008140492087,5
012301,1175,1132,2920,5227,012301,0.22479433709584848,0.21656782092978763,0.5586378419743638,6
012303,334,388,1363,2085,012303,0.16019184652278176,0.18609112709832135,0.6537170263788968,6
012304,826,693,2500,4019,012304,0.20552376212988305,0.17243095297337646,0.6220452848967405,6
012305,458,414,1233,2105,012305,0.21757719714964371,0.19667458432304039,0.585748218527316,6
012306,443,397,1502,2342,012306,0.1891545687446627,0.1695132365499573,0.64133219470538,6
012400,2263,2807,7605,12675,012400,0.1785404339250493,0.22145956607495068,0.6,6
012401,1108,1591,1686,4385,012401,0.25267958950969216,0.3628278221208666,0.3844925883694413,5
012402,1230,1462,2462,5154,012402,0.23864959254947612,0.283663174233605,0.4776872332169189,6
012500,2836,3597,5934,12367,012500,0.22931996442144417,0.29085469394355945,0.47982534163499635,6
012501,1280,1678,2607,5565,012501,0.23000898472596587,0.30152740341419587,0.46846361185983826,5
012502,1128,1365,2972,5465,012502,0.20640439158279963,0.24977127172918573,0.5438243366880147,6
012503,321,303,1232,1856,012503,0.17295258620689655,0.1632543103448276,0.6637931034482759,6
012600,3847,4022,12249,20118,012600,0.1912217914305597,0.19992046923153395,0.6088577393379063,6
012601,661,854,1144,2659,012601,0.24858969537420084,0.3211733734486649,0.43023693117713424,5
012602,689,943,1075,2707,012602,0.25452530476542296,0.34835611377909126,0.3971185814554858,5
012700,3436,3691,8736,15863,012700,0.216604677551535,0.2326798209670302,0.5507155014814348,6
012701,830,1276,1198,3304,012701,0.25121065375302665,0.38619854721549635,0.362590799031477,5
012702,529,734,1011,2274,012702,0.2326297273526825,0.3227792436235708,0.4445910290237467,5
012800,3905,4959,9050,17914,012800,0.21798593278999664,0.2768225968516244,0.505191470358379,6
012801,297,328,327,952,012801,0.3119747899159664,0.3445378151260504,0.3434873949579832,3
012802,619,623,1871,3113,012802,0.19884355926758754,0.2001284934147125,0.6010279473176999,6
012804,417,492,946,1855,012804,0.2247978436657682,0.2652291105121294,0.5099730458221025,6
012805,286,264,738,1288,012805,0.2220496894409938,0.20496894409937888,0.5729813664596274,6
012806,521,652,1315,2488,012806,0.20940514469453375,0.2620578778135048,0.5285369774919614,6
012900,2770,3277,6993,13040,012900,0.21242331288343558,0.2513036809815951,0.5362730061349693,6
012901,1512,2128,2671,6311,012901,0.23958168277610523,0.33718903501822217,0.42322928220567263,5
012902,739,691,1677,3107,012902,0.2378500160926939,0.22240102993241068,0.5397489539748954,6
013000,3634,4382,8388,16404,013000,0.22153133382101928,0.2671299683004145,0.5113386978785662,6
013001,1665,1719,2521,5905,013001,0.2819644369178662,0.29110922946655376,0.42692633361558,6
013002,2102,2280,4269,8651,013002,0.2429776904404115,0.2635533464339383,0.4934689631256502,6
013003,274,254,795,1323,013003,0.20710506424792138,0.19198790627362056,0.6009070294784581,6
013100,3554,4200,8064,15818,013100,0.22468074345682135,0.265520293336705,0.5097989632064737,6
013101,1699,2062,3034,6795,013101,0.25003679175864607,0.30345842531272993,0.446504782928624,5
013102,1456,1500,3840,6796,013102,0.2142436727486757,0.22071806945261918,0.5650382577987051,6
013103,690,681,1900,3271,013103,0.21094466523998778,0.20819321308468358,0.5808621216753287,6
013104,1117,1263,2351,4731,013104,0.23610230395265272,0.26696258719086874,0.49693510885647857,6
013200,2602,3125,7973,13700,013200,0.18992700729927006,0.2281021897810219,0.581970802919708,6
013201,2176,2411,4631,9218,013201,0.2360598828379258,0.2615534823172055,0.5023866348448688,6
013202,1548,1689,3304,6541,013202,0.23666106099984713,0.2582173979513836,0.5051215410487693,6
013203,1206,1352,2498,5056,013203,0.23852848101265822,0.2674050632911392,0.49406645569620256,6
013204,1499,1642,3070,6211,013204,0.241345999033972,0.2643696667203349,0.4942843342456931,6
013205,618,702,933,2253,013205,0.27430093209054596,0.31158455392809586,0.4141145139813582,5
013206,713,765,1670,3148,013206,0.22649301143583228,0.24301143583227447,0.5304955527318933,6
013300,4270,5116,10154,19540,013300,0.21852610030706243,0.2618219037871034,0.5196519959058342,6
013301,1149,1499,1688,4336,013301,0.2649907749077491,0.345710332103321,0.3892988929889299,5
013302,328,476,514,1318,013302,0.2488619119878604,0.3611532625189681,0.3899848254931715,5
013303,306,393,581,1280,013303,0.2390625,0.30703125,0.45390625,5
013304,1127,1398,2283,4808,013304,0.2344009983361065,0.29076539101497506,0.4748336106489185,6
013400,5304,6462,14354,26120,013400,0.20306278713629403,0.24739663093415007,0.5495405819295559,6
013401,1053,1267,1930,4250,013401,0.24776470588235294,0.29811764705882354,0.4541176470588235,6
013402,798,866,1824,3488,013402,0.22878440366972477,0.24827981651376146,0.5229357798165137,6
013500,3402,4242,8582,16226,013500,0.20966350301984468,0.2614322691975841,0.5289042277825712,6
013501,794,869,1739,3402,013501,0.23339212228101117,0.2554379776601999,0.5111699000587889,6
013502,806,729,1879,3414,013502,0.23608670181605154,0.21353251318101935,0.5503807850029291,6
013503,1270,1520,2747,5537,013503,0.22936608271627235,0.2745168864005779,0.49611703088314973,6
013505,868,1185,1457,3510,013505,0.2472934472934473,0.33760683760683763,0.4150997150997151,5
013506,1884,2235,3863,7982,013506,0.23603106990729142,0.2800050112753696,0.483963918817339,6
013507,1155,1250,2220,4625,013507,0.24972972972972973,0.2702702702702703,0.48,6
013508,1191,1305,2873,5369,013508,0.22182901843918792,0.24306202272303967,0.5351089588377724,6
013600,3338,4090,10919,18347,013600,0.18193710143347686,0.2229247288385022,0.5951381697280209,6
013601,1589,2065,2958,6612,013601,0.24032062915910465,0.31231094978826374,0.4473684210526316,5
013602,380,522,1135,2037,013602,0.18654884634266078,0.25625920471281294,0.5571919489445263,6
013603,682,838,1335,2855,013603,0.23887915936952714,0.2935201401050788,0.46760070052539404,6
013604,754,872,929,2555,013604,0.2951076320939335,0.3412915851272016,0.363600782778865,5
013700,2181,2402,6775,11358,013700,0.19202324352879027,0.21148089452368374,0.596495861947526,6
013701,1725,2279,2628,6632,013701,0.260102533172497,0.3436369119420989,0.3962605548854041,5
013702,1173,1287,2208,4668,013702,0.2512853470437018,0.27570694087403597,0.4730077120822622,6
013703,228,252,543,1023,013703,0.22287390029325513,0.24633431085043989,0.530791788856305,6
013705,718,901,1745,3364,013705,0.21343638525564804,0.2678359096313912,0.5187277051129607,6
013706,200,222,644,1066,013706,0.18761726078799248,0.20825515947467166,0.6041275797373359,6
013707,661,735,1675,3071,013707,0.21523933572126344,0.2393357212634321,0.5454249430153044,6
013800,5257,6239,14142,25638,013800,0.20504719556907716,0.24334971526640142,0.5516030891645214,6
013801,888,1114,1868,3870,013801,0.22945736434108527,0.28785529715762276,0.482687338501292,6
013802,566,531,1344,2441,013802,0.23187218353133962,0.2175337976239246,0.5505940188447358,6
013900,3013,3254,8480,14747,013900,0.20431274157455753,0.2206550484844375,0.5750322099410049,6
013901,859,1218,1387,3464,013901,0.24797921478060045,0.35161662817551964,0.4004041570438799,5
013902,1176,1738,1911,4825,013902,0.24373056994818654,0.3602072538860104,0.3960621761658031,5
014000,2536,3050,6293,11879,014000,0.21348598366865898,0.25675561915986195,0.5297583971714791,6
014001,1130,1462,2028,4620,014001,0.24458874458874458,0.3164502164502164,0.43896103896103894,5
014002,535,809,1014,2358,014002,0.2268871925360475,0.3430873621713316,0.4300254452926209,5
014003,595,918,787,2300,014003,0.25869565217391305,0.3991304347826087,0.3421739130434783,5
014004,508,717,747,1972,014004,0.25760649087221094,0.36359026369168357,0.3788032454361055,5
014100,2934,3783,6393,13110,014100,0.22379862700228834,0.288558352402746,0.48764302059496567,6
014101,1114,1275,2544,4933,014101,0.22582606932900873,0.2584634096898439,0.5157105209811473,6
014102,1753,1985,3595,7333,014102,0.2390563207418519,0.2706941224601118,0.4902495567980363,6
014103,509,670,1064,2243,014103,0.22692822113241196,0.29870708872046364,0.4743646901471244,6
014104,423,485,773,1681,014104,0.25163593099345627,0.28851873884592505,0.4598453301606187,6
014200,1757,2272,3842,7871,014200,0.22322449498157795,0.28865455469444795,0.48812095032397407,6
014201,1497,1816,3182,6495,014201,0.2304849884526559,0.2795996920708237,0.4899153194765204,6
014202,2323,2732,5235,10290,014202,0.22575315840621962,0.26550048590864916,0.5087463556851312,6
014203,1422,1955,3105,6482,014203,0.21937673557543969,0.30160444307312556,0.47901882135143475,5
014204,940,1021,1638,3599,014204,0.26118366212836897,0.2836899138649625,0.45512642400666853,6
014206,1014,851,2331,4196,014206,0.24165872259294566,0.20281220209723547,0.5555290753098189,6
014207,724,801,1520,3045,014207,0.23776683087027914,0.2630541871921182,0.49917898193760263,6
014208,772,766,1507,3045,014208,0.2535303776683087,0.251559934318555,0.4949096880131363,6
014209,616,586,1217,2419,014209,0.2546506821000413,0.24224886316659777,0.5031004547333608,6
014300,2549,3489,4829,10867,014300,0.23456335695224073,0.3210637710499678,0.44437287199779146,5
014301,1732,2152,3402,7286,014301,0.23771616799341203,0.29536096623661817,0.46692286576996983,6
014302,2475,2892,5578,10945,014302,0.22613065326633167,0.2642302421196894,0.509639104613979,6
014400,3898,5147,6761,15806,014400,0.24661520941414652,0.3256358344932304,0.42774895609262303,5
014401,659,755,2635,4049,014401,0.16275623610768092,0.18646579402321561,0.6507779698691035,6
014402,774,971,3389,5134,014402,0.15075964160498637,0.18913128165173354,0.6601090767432801,6
014500,2919,3997,6967,13883,014500,0.21025714903118922,0.287906072174602,0.5018367787942087,6
014501,1855,2228,3811,7894,014501,0.23498859893590068,0.28223967570306563,0.4827717253610337,6
014502,1237,1506,2633,5376,014502,0.2300967261904762,0.28013392857142855,0.48976934523809523,6
014503,766,943,1605,3314,014503,0.2311406155703078,0.28455039227519613,0.4843089921544961,6
014504,775,950,1503,3228,014504,0.24008674101610905,0.2942998760842627,0.4656133828996282,6
014505,685,891,1133,2709,014505,0.2528608342561831,0.3289036544850498,0.41823551125876707,5
014600,1958,2121,3485,7564,014600,0.25885774722369115,0.28040719196192493,0.4607350608143839,6
014601,1667,1769,4919,8355,014601,0.1995212447636146,0.21172950329144224,0.5887492519449431,6
014602,1142,1332,4461,6935,014602,0.16467195385724587,0.19206921413121847,0.6432588320115357,6
014603,530,525,1153,2208,014603,0.24003623188405798,0.23777173913043478,0.5221920289855072,6
014604,1957,1945,4764,8666,014604,0.2258250634664205,0.22444034156473575,0.5497345949688438,6
014605,648,678,1736,3062,014605,0.2116263879817113,0.22142390594382758,0.5669497060744612,6
014606,1467,1538,4134,7139,014606,0.20549096512116544,0.21543633562123546,0.5790726992575991,6
014607,1676,1805,4845,8326,014607,0.20129714148450636,0.21679077588277684,0.5819120826327168,6
014608,768,803,1677,3248,014608,0.23645320197044334,0.24722906403940886,0.5163177339901478,6
014609,489,667,1344,2500,014609,0.1956,0.2668,0.5376,6
014611,194,243,543,980,014611,0.19795918367346937,0.2479591836734694,0.5540816326530612,6
014612,173,213,400,786,014612,0.22010178117048346,0.27099236641221375,0.5089058524173028,6
014613,362,428,690,1480,014613,0.2445945945945946,0.2891891891891892,0.46621621621621623,6
014614,599,645,1516,2760,014614,0.21702898550724636,0.23369565217391305,0.5492753623188406,6
014615,193,272,680,1145,014615,0.1685589519650655,0.23755458515283842,0.5938864628820961,6
014700,3169,3540,8136,14845,014700,0.21347254968002694,0.23846412933647693,0.5480633209834961,6
014701,2077,2277,3194,7548,014701,0.275172231054584,0.3016693163751987,0.4231584525702173,5
014702,1588,1783,2163,5534,014702,0.2869533791109505,0.322190097578605,0.3908565233104445,5
014703,601,649,1788,3038,014703,0.1978275181040158,0.21362738643844634,0.5885450954575379,6
014704,189,208,501,898,014704,0.21046770601336304,0.23162583518930957,0.5579064587973274,6
014800,1257,1570,2667,5494,014800,0.22879504914452128,0.2857662904987259,0.4854386603567528,6
014801,762,942,2337,4041,014801,0.18856718634001485,0.23311061618411286,0.5783221974758723,6
014802,1270,1458,4126,6854,014802,0.18529325941056318,0.21272249781149694,0.6019842427779399,6
014803,1502,1908,3075,6485,014803,0.23161141094834234,0.29421742482652274,0.47417116422513494,6
014804,1700,1898,3637,7235,014804,0.2349689011748445,0.26233586731167935,0.5026952315134762,6
014805,362,352,1239,1953,014805,0.18535586277521762,0.18023553507424475,0.6344086021505376,6
014806,607,615,1950,3172,014806,0.19136191677175285,0.19388398486759142,0.6147540983606558,6
014808,315,320,1100,1735,014808,0.18155619596541786,0.1844380403458213,0.6340057636887608,6
014809,558,555,1868,2981,014809,0.18718550821871854,0.18617913451861792,0.6266353572626635,6
014810,171,162,502,835,014810,0.20479041916167665,0.19401197604790418,0.6011976047904192,6
014811,538,517,1764,2819,014811,0.1908478183753104,0.1833983682156793,0.6257538134090103,6
014900,2163,2507,6070,10740,014900,0.20139664804469273,0.2334264432029795,0.5651769087523277,6
014901,1635,1822,3557,7014,014901,0.23310521813515825,0.25976618192187056,0.5071285999429712,6
014903,1646,1928,3758,7332,014903,0.22449536279323512,0.2629569012547736,0.5125477359519913,6
014904,57,58,66,181,014904,0.3149171270718232,0.32044198895027626,0.36464088397790057,3
014905,772,932,1417,3121,014905,0.24735661646908041,0.2986222364626722,0.45402114706824737,6
014906,538,528,934,2000,014906,0.269,0.264,0.467,6
014907,361,368,1396,2125,014907,0.16988235294117648,0.1731764705882353,0.6569411764705883,6
014908,263,248,945,1456,014908,0.18063186813186813,0.17032967032967034,0.6490384615384616,6
014909,228,238,760,1226,014909,0.1859706362153344,0.19412724306688417,0.6199021207177814,6
015000,1963,2351,4577,8891,015000,0.22078506354740748,0.26442469913395567,0.5147902373186368,6
015001,823,935,2122,3880,015001,0.21211340206185567,0.24097938144329897,0.5469072164948454,6
015002,638,689,2285,3612,015002,0.17663344407530454,0.1907530454042082,0.6326135105204873,6
015003,1034,1248,1304,3586,015003,0.2883435582822086,0.34802007808142776,0.36363636363636365,5
015004,858,818,834,2510,015004,0.34183266932270917,0.3258964143426295,0.3322709163346614,3
015005,508,503,574,1585,015005,0.3205047318611987,0.3173501577287066,0.3621451104100946,3
015006,742,785,874,2401,015006,0.30903790087463556,0.32694710537276134,0.3640149937526031,3
015100,3664,4531,8904,17099,015100,0.21428153693198432,0.2649862565062284,0.5207322065617872,6
015101,1116,1391,1804,4311,015101,0.2588726513569937,0.3226629552308049,0.4184643934122013,5
015102,825,1133,1353,3311,015102,0.24916943521594684,0.34219269102990035,0.40863787375415284,5
015200,2854,3587,7007,13448,015200,0.21222486615110053,0.26673111243307557,0.521044021415824,6
015201,873,852,1636,3361,015201,0.2597441237726867,0.25349598333829215,0.4867598928890211,6
015202,1097,1221,2253,4571,015202,0.2399912491796106,0.26711879238678626,0.49288995843360317,6
015203,326,295,690,1311,015203,0.2486651411136537,0.2250190694126621,0.5263157894736842,6
015300,1589,1763,5684,9036,015300,0.1758521469676848,0.19510845506861443,0.6290393979637008,6
015301,873,903,1368,3144,015301,0.2776717557251908,0.2872137404580153,0.4351145038167939,6
015302,351,440,663,1454,015302,0.24140302613480055,0.30261348005502064,0.45598349381017883,5
015303,419,450,626,1495,015303,0.2802675585284281,0.3010033444816054,0.4187290969899666,5
015304,568,667,635,1870,015304,0.3037433155080214,0.35668449197860963,0.339572192513369,3
015400,2188,2872,7703,12763,015400,0.17143304865627204,0.2250254642325472,0.6035414871111807,6
015401,404,487,585,1476,015401,0.27371273712737126,0.32994579945799457,0.39634146341463417,5
015402,658,819,1167,2644,015402,0.24886535552193645,0.3097579425113464,0.4413767019667171,5
015500,1735,1981,6029,9745,015500,0.1780400205233453,0.20328373524884555,0.6186762442278091,6
015501,268,359,442,1069,015501,0.2507015902712816,0.33582787652011226,0.41347053320860616,5
015503,337,444,505,1286,015503,0.2620528771384137,0.3452566096423017,0.3926905132192846,5
015504,509,676,709,1894,015504,0.26874340021119325,0.35691657866948256,0.3743400211193242,5
015600,536,860,893,2289,015600,0.23416339012669288,0.37570991699432066,0.39012669287898644,5
015601,1266,1515,4575,7356,015601,0.17210440456769985,0.20595432300163133,0.6219412724306689,6
015602,561,624,1445,2630,015602,0.21330798479087454,0.23726235741444868,0.5494296577946768,6
015603,338,407,1022,1767,015603,0.19128466327108093,0.23033389926428977,0.5783814374646293,6
015700,2949,3334,8643,14926,015700,0.19757470186252177,0.22336861851802225,0.579056679619456,6
015800,1275,1565,2289,5129,015800,0.24858646909728993,0.3051277052056931,0.44628582569701697,5
015801,599,928,2716,4243,015801,0.14117369785529107,0.21871317464058448,0.6401131275041244,6
015802,727,1184,2215,4126,015802,0.17619970916141542,0.286960736791081,0.5368395540475036,6
015900,2161,2427,7639,12227,015900,0.1767400016357242,0.19849513372045474,0.6247648646438211,6
016000,682,923,1803,3408,016000,0.20011737089201878,0.2708333333333333,0.5290492957746479,6
016001,614,737,1963,3314,016001,0.18527459263729631,0.2223898611949306,0.5923355461677731,6
016002,647,740,1797,3184,016002,0.2032035175879397,0.23241206030150754,0.5643844221105527,6
016100,1892,2180,5557,9629,016100,0.19648977048499325,0.2263994184235123,0.5771108110914944,6
016200,1894,2523,3013,7430,016200,0.25491251682368776,0.3395693135935397,0.40551816958277254,5
016300,2447,2736,6107,11290,016300,0.21674047829937998,0.24233835252435784,0.5409211691762622,6
016400,2037,2837,3231,8105,016400,0.251326341764343,0.3500308451573103,0.3986428130783467,5
016500,1236,1215,4575,7026,016500,0.17591801878736124,0.17292912040990607,0.6511528608027327,6
016501,267,279,451,997,016501,0.2678034102306921,0.279839518555667,0.45235707121364094,6
016502,535,583,1014,2132,016502,0.25093808630394,0.27345215759849906,0.47560975609756095,6
016600,2273,3058,4203,9534,016600,0.23840990140549612,0.3207468009230124,0.4408432976714915,5
016700,1754,1954,5180,8888,016700,0.19734473447344736,0.21984698469846986,0.5828082808280828,6
016800,1362,1823,1913,5098,016800,0.26716359356610436,0.35759121224009416,0.3752451941938015,5
016801,173,216,349,738,016801,0.23441734417344173,0.2926829268292683,0.47289972899729,6
016802,276,400,508,1184,016802,0.23310810810810811,0.33783783783783783,0.42905405405405406,5
016900,2252,2531,6513,11296,016900,0.19936260623229463,0.22406161473087818,0.5765757790368272,6
016901,603,711,1404,2718,016901,0.22185430463576158,0.26158940397350994,0.5165562913907285,6
016902,280,280,424,984,016902,0.2845528455284553,0.2845528455284553,0.43089430894308944,6
017000,1635,2276,2302,6213,017000,0.2631578947368421,0.36632866570094963,0.3705134395622083,5
017005,395,426,1088,1909,017005,0.2069146149816658,0.22315348349921424,0.56993190151912,6
017007,420,524,1182,2126,017007,0.1975540921919097,0.2464722483537159,0.5559736594543744,6
017008,687,722,1639,3048,017008,0.22539370078740156,0.2368766404199475,0.5377296587926509,6
017009,389,392,1091,1872,017009,0.2077991452991453,0.2094017094017094,0.5827991452991453,6
017010,785,913,2007,3705,017010,0.21187584345479082,0.24642375168690958,0.5417004048582996,6
017011,429,496,1102,2027,017011,0.21164282190429207,0.24469659595461274,0.5436605821410952,6
017012,375,439,1044,1858,017012,0.20182992465016147,0.23627556512378903,0.5618945102260495,6
017100,1672,1699,4620,7991,017100,0.20923538981354023,0.21261419096483544,0.5781504192216244,6
017200,1294,1962,2179,5435,017200,0.23808647654093837,0.3609935602575897,0.40091996320147194,5
017300,2477,2986,5648,11111,017300,0.22293222932229323,0.2687426874268743,0.5083250832508325,6
017400,927,1280,1104,3311,017400,0.279975838115373,0.3865901540320145,0.3334340078526125,5
017401,557,759,851,2167,017401,0.25703737886479006,0.350253807106599,0.39270881402861096,5
017402,281,400,598,1279,017402,0.21970289288506645,0.3127443315089914,0.46755277560594216,5
017500,1426,1692,3870,6988,017500,0.20406410990269033,0.24212936462507156,0.5538065254722381,6
017501,196,296,248,740,017501,0.2648648648648649,0.4,0.33513513513513515,5
017502,281,333,432,1046,017502,0.26864244741873805,0.31835564053537285,0.4130019120458891,5
017600,904,1057,2051,4012,017600,0.22532402791625125,0.2634596211365902,0.5112163509471586,6
017700,1424,1544,4207,7175,017700,0.19846689895470385,0.215191637630662,0.5863414634146341,6
017701,423,699,364,1486,017701,0.28465679676985195,0.47039030955585465,0.2449528936742934,4
017702,494,733,387,1614,017702,0.30607187112763323,0.4541511771995043,0.23977695167286245,1
017800,895,1292,1573,3760,017800,0.23803191489361702,0.34361702127659577,0.4183510638297872,5
017900,1196,1317,4097,6610,017900,0.18093797276853252,0.19924357034795764,0.6198184568835098,6
017901,550,947,511,2008,017901,0.2739043824701195,0.4716135458167331,0.2544820717131474,4
017902,410,692,360,1462,017902,0.280437756497948,0.47332421340629277,0.24623803009575923,4
018000,1263,1744,1853,4860,018000,0.2598765432098765,0.3588477366255144,0.38127572016460903,5
018100,1193,1352,5059,7604,018100,0.15689110994213573,0.17780115728563914,0.6653077327722251,6
018101,783,1217,1439,3439,018101,0.227682465833091,0.3538819424251236,0.4184355917417854,5
018102,1062,1549,1841,4452,018102,0.238544474393531,0.34793351302785264,0.41352201257861637,5
018200,1297,1937,1728,4962,018200,0.2613865376864168,0.39036678758565097,0.3482466747279323,5
018300,1481,1750,5360,8591,018300,0.17238971016179722,0.2037015481317658,0.623908741706437,6
018301,547,721,747,2015,018301,0.2714640198511166,0.3578163771712159,0.3707196029776675,5
018302,427,662,460,1549,018302,0.27566171723692706,0.4273724983860555,0.2969657843770174,4
018400,1329,1828,2616,5773,018400,0.2302095963970206,0.3166464576476702,0.4531439459553092,5
018401,232,427,319,978,018401,0.23721881390593047,0.43660531697341515,0.3261758691206544,5
018402,190,347,314,851,018402,0.22326674500587543,0.40775558166862513,0.3689776733254994,5
018500,1107,1619,2425,5151,018500,0.21490972626674432,0.3143079013783731,0.4707823723548826,5
018501,838,1131,1604,3573,018501,0.23453680380632522,0.3165407220822838,0.44892247411139097,5
018502,367,502,1061,1930,018502,0.19015544041450777,0.2601036269430052,0.549740932642487,6
018600,1013,1382,1413,3808,018600,0.2660189075630252,0.3629201680672269,0.3710609243697479,5
018700,1282,1412,3823,6517,018700,0.19671628049716128,0.21666410925272364,0.5866196102501151,6
018701,177,271,504,952,018701,0.18592436974789917,0.2846638655462185,0.5294117647058824,6
018702,644,881,1556,3081,018702,0.20902304446608244,0.28594612138915937,0.5050308341447582,6
018800,1018,1298,1578,3894,018800,0.2614278376990241,0.3333333333333333,0.4052388289676425,5
018900,2232,3106,3870,9208,018900,0.24239791485664638,0.3373153779322328,0.42028670721112077,5
018901,537,644,1287,2468,018901,0.21758508914100486,0.26094003241491087,0.5214748784440842,6
018902,471,652,1100,2223,018902,0.21187584345479082,0.29329734592892487,0.4948268106162843,6
019000,1085,1403,1849,4337,019000,0.250172930597187,0.3234955038044731,0.42633156559833985,5
019100,1085,1052,3585,5722,019100,0.18961901433065362,0.18385180006990562,0.6265291855994407,6
019200,866,1136,1017,3019,019200,0.28684995031467375,0.3762835375952302,0.33686651209009605,5
019300,2184,2673,3819,8676,019300,0.2517289073305671,0.30809128630705396,0.44017980636237897,5
019400,1550,2154,2180,5884,019400,0.26342624065261727,0.36607749830047587,0.37049626104690686,5
019500,1964,2486,4522,8972,019500,0.21890325456977264,0.2770842621489077,0.5040124832813196,6
019600,1055,1524,1589,4168,019600,0.2531190019193858,0.3656429942418426,0.3812380038387716,5
019700,1342,1927,2586,5855,019700,0.2292058070025619,0.32912040990606317,0.4416737830913749,5
019701,87,112,213,412,019701,0.2111650485436893,0.27184466019417475,0.5169902912621359,6
019702,332,347,840,1519,019702,0.2185648452929559,0.228439763001975,0.5529953917050692,6
019800,1287,1686,2957,5930,019800,0.2170320404721754,0.28431703204047215,0.49865092748735246,6
019900,2077,2461,4145,8683,019900,0.23920304042381665,0.2834273868478636,0.4773695727283197,6
020000,1027,1236,1737,4000,020000,0.25675,0.309,0.43425,5
020003,424,464,863,1751,020003,0.24214734437464305,0.26499143346659054,0.49286122215876643,6
020004,271,256,614,1141,020004,0.23751095530236635,0.22436459246275198,0.5381244522348817,6
020005,521,538,1155,2214,020005,0.23532068654019875,0.24299909665763325,0.521680216802168,6
020100,2560,3533,4720,10813,020100,0.23675205770831406,0.32673633589198187,0.43651160639970404,5
020101,959,1283,2252,4494,020101,0.21339563862928349,0.285491766800178,0.5011125945705385,6
020102,1495,2139,2697,6331,020102,0.23613963039014374,0.3378613173274364,0.42599905228241985,5
020200,2237,3041,3051,8329,020200,0.26857966142394046,0.3651098571257054,0.36631048145035416,5
020201,608,720,1148,2476,020201,0.2455573505654281,0.29079159935379645,0.46365105008077545,6
020202,536,655,1313,2504,020202,0.21405750798722045,0.2615814696485623,0.5243610223642172,6
020300,1919,2252,3179,7350,020300,0.26108843537414966,0.30639455782312924,0.4325170068027211,5
020301,750,912,1178,2840,020301,0.2640845070422535,0.3211267605633803,0.4147887323943662,5
020302,960,1382,1818,4160,020302,0.23076923076923078,0.33221153846153845,0.43701923076923077,5
020400,1452,2043,2328,5823,020400,0.24935600206079342,0.3508500772797527,0.3997939206594539,5
020401,875,1207,1653,3735,020401,0.23427041499330656,0.32315930388219544,0.442570281124498,5
020402,897,1177,1689,3763,020402,0.23837363805474354,0.3127823545043848,0.44884400744087166,5
020500,3191,4315,6110,13616,020500,0.2343566392479436,0.31690658049353704,0.4487367802585194,5
020501,745,1184,719,2648,020501,0.28134441087613293,0.4471299093655589,0.27152567975830816,4
020502,227,358,275,860,020502,0.26395348837209304,0.41627906976744183,0.31976744186046513,5
020600,3057,4248,4980,12285,020600,0.24884004884004884,0.3457875457875458,0.4053724053724054,5
020601,306,468,522,1296,020601,0.2361111111111111,0.3611111111111111,0.4027777777777778,5
020700,2412,3525,4151,10088,020700,0.23909595559080096,0.34942505947660585,0.41147898493259316,5
020701,1274,1477,2074,4825,020701,0.2640414507772021,0.3061139896373057,0.4298445595854922,5
020702,901,1475,1477,3853,020702,0.2338437581105632,0.3828185829223981,0.3833376589670387,5
020703,1081,1584,1631,4296,020703,0.25162942271880817,0.3687150837988827,0.37965549348230915,5
020705,233,432,276,941,020705,0.24760892667375134,0.45908607863974493,0.29330499468650373,4
020800,2324,3268,3627,9219,020800,0.25208807896735,0.35448530209350254,0.39342661893914743,5
020801,790,902,1948,3640,020801,0.21703296703296704,0.2478021978021978,0.5351648351648352,6
020802,369,603,238,1210,020802,0.3049586776859504,0.4983471074380165,0.19669421487603306,1
020803,806,1044,1572,3422,020803,0.23553477498538866,0.3050847457627119,0.45938047925189945,5
020804,482,489,1298,2269,020804,0.2124283825473777,0.21551344204495373,0.5720581754076686,6
020900,2011,2857,1885,6753,020900,0.29779357322671407,0.423071227602547,0.2791351991707389,4
020901,719,1001,910,2630,020901,0.27338403041825093,0.3806083650190114,0.34600760456273766,5
020902,641,891,1160,2692,020902,0.23811292719167904,0.33098068350668647,0.4309063893016345,5
021000,3083,4165,4572,11820,021000,0.26082910321489,0.3523688663282572,0.3868020304568528,5
021001,1065,1520,1742,4327,021001,0.24612895770741852,0.35128264386410907,0.4025883984284724,5
021002,908,1504,1668,4080,021002,0.22254901960784312,0.3686274509803922,0.4088235294117647,5
021100,2603,3362,4169,10134,021100,0.2568581014406947,0.331754489836195,0.4113874087231103,5
021101,536,782,501,1819,021101,0.29466739967014843,0.42990654205607476,0.2754260582737768,4
021102,519,705,455,1679,021102,0.30911256700416917,0.4198927933293627,0.27099463966646814,1
021103,547,687,755,1989,021103,0.2750125691302162,0.3453996983408748,0.379587732528909,5
021104,285,421,398,1104,021104,0.25815217391304346,0.3813405797101449,0.3605072463768116,5
021200,3682,5152,5532,14366,021200,0.2562995962689684,0.3586245301406098,0.38507587359042184,5
021201,196,406,109,711,021201,0.27566807313642755,0.5710267229254571,0.15330520393811534,4
021202,335,526,192,1053,021202,0.3181386514719848,0.49952516619183285,0.18233618233618235,1
021300,1696,2406,2668,6770,021300,0.25051698670605616,0.3553914327917282,0.39409158050221565,5
021301,548,673,617,1838,021301,0.2981501632208923,0.3661588683351469,0.33569096844396085,5
021302,991,1641,934,3566,021302,0.27790241166573193,0.46017947279865395,0.2619181155356141,4
021303,1005,1307,1484,3796,021303,0.26475237091675446,0.34430979978925186,0.3909378292939937,5
021400,2330,3175,3426,8931,021400,0.2608890381816146,0.35550330310155637,0.383607658716829,5
021401,951,1183,1298,3432,021401,0.2770979020979021,0.3446969696969697,0.3782051282051282,5
021402,436,548,558,1542,021402,0.2827496757457847,0.3553826199740597,0.36186770428015563,5
021500,1648,2362,3021,7031,021500,0.23439055610866164,0.33594083345185605,0.4296686104394823,5
021501,1007,1586,1388,3981,021501,0.25295151971866364,0.3983923637277066,0.3486561165536297,5
021502,1773,2570,2308,6651,021502,0.2665764546684709,0.3864080589385055,0.3470154863930236,5
021600,2568,3512,4503,10583,021600,0.24265331191533593,0.3318529717471416,0.4254937163375224,5
021601,1367,1913,1792,5072,021601,0.26951892744479494,0.3771687697160883,0.35331230283911674,5
021602,1203,1622,2067,4892,021602,0.24591169255928047,0.33156173344235484,0.4225265739983647,5
021603,502,560,770,1832,021603,0.2740174672489083,0.3056768558951965,0.4203056768558952,5
021604,480,527,655,1662,021604,0.2888086642599278,0.31708784596871237,0.3941034897713598,5
021605,465,579,434,1478,021605,0.31461434370771313,0.39174560216508797,0.2936400541271989,1
021700,2214,3272,2961,8447,021700,0.2621048893098141,0.3873564579140523,0.35053865277613355,5
021701,382,447,708,1537,021701,0.24853610930383865,0.29082628497072216,0.46063760572543916,6
021702,333,481,461,1275,021702,0.2611764705882353,0.3772549019607843,0.3615686274509804,5
021703,51,42,61,154,021703,0.33116883116883117,0.2727272727272727,0.3961038961038961,2
021800,2801,3575,4445,10821,021800,0.25884853525552165,0.3303761205064227,0.4107753442380556,5
021900,1447,2230,2123,5800,021900,0.24948275862068967,0.38448275862068965,0.3660344827586207,5
022000,2323,2807,2975,8105,022000,0.2866132017273288,0.346329426280074,0.36705737199259714,5
022001,556,788,1650,2994,022001,0.18570474281897129,0.2631930527722111,0.5511022044088176,6
022002,550,708,1288,2546,022002,0.21602513747054203,0.27808326787117044,0.5058915946582875,6
022100,995,1471,1816,4282,022100,0.23236805231200375,0.3435310602522186,0.4241008874357777,5
022101,397,657,394,1448,022101,0.27417127071823205,0.4537292817679558,0.27209944751381215,4
022102,863,1107,1073,3043,022102,0.28360170883996055,0.3637857377587907,0.35261255340124875,5
022200,1986,2390,2823,7199,022200,0.27587164884011667,0.33199055424364493,0.39213779691623835,5
022300,1225,1824,1606,4655,022300,0.2631578947368421,0.39183673469387753,0.3450053705692803,5
022301,844,1298,1144,3286,022301,0.25684723067559345,0.3950091296409008,0.34814363968350576,5
022302,430,541,648,1619,022302,0.2655960469425571,0.33415688696726376,0.4002470660901791,5
022400,1727,2115,1939,5781,022400,0.29873724269157587,0.36585365853658536,0.3354090987718388,5
022401,454,687,845,1986,022401,0.22860020140986909,0.3459214501510574,0.4254783484390735,5
022403,267,473,603,1343,022403,0.19880863737900223,0.35219657483246464,0.44899478778853313,5
022404,374,665,844,1883,022404,0.19861922464152948,0.35315985130111527,0.4482209240573553,5
022500,2710,4108,3334,10152,022500,0.2669424743892829,0.40464933018124505,0.328408195429472,5
022600,1353,1723,3029,6105,022600,0.22162162162162163,0.28222768222768224,0.4961506961506961,6
022601,307,461,386,1154,022601,0.26603119584055457,0.39948006932409014,0.3344887348353553,5
022602,842,1065,956,2863,022602,0.29409710094306674,0.3719874257771568,0.33391547327977644,5
022700,968,1206,1915,4089,022700,0.23673269748104672,0.2949376375641966,0.46832966495475664,6
022701,825,1233,912,2970,022701,0.2777777777777778,0.41515151515151516,0.30707070707070705,5
022702,1563,1924,2738,6225,022702,0.2510843373493976,0.30907630522088353,0.43983935742971886,5
022703,184,347,295,826,022703,0.22276029055690072,0.42009685230024213,0.35714285714285715,5
022711,1085,1198,1984,4267,022711,0.2542770096086243,0.28075931567846263,0.46496367471291306,6
022712,904,1133,1658,3695,022712,0.24465493910690123,0.30663058186738834,0.44871447902571043,5
022800,1738,2411,3094,7243,022800,0.23995581941184593,0.332873118873395,0.4271710617147591,5
022803,434,564,758,1756,022803,0.24715261958997722,0.3211845102505695,0.4316628701594533,5
022804,421,563,705,1689,022804,0.2492599171107164,0.3333333333333333,0.41740674955595025,5
022900,1388,1912,2516,5816,022900,0.23865199449793673,0.328748280605227,0.4325997248968363,5
022901,892,1326,873,3091,022901,0.28857974765448074,0.4289873827240375,0.28243286962148173,4
022902,816,1160,931,2907,022902,0.2807017543859649,0.39903680770553834,0.3202614379084967,5
023000,2563,3424,3581,9568,023000,0.2678720735785953,0.35785953177257523,0.37426839464882944,5
023001,298,384,347,1029,023001,0.28960155490767736,0.37317784256559766,0.337220602526725,5
023100,2057,2702,3526,8285,023100,0.24828002414001207,0.32613156306578156,0.4255884127942064,5
023200,3046,4179,3974,11199,023200,0.27198857040807217,0.37315831770693814,0.35485311188498975,5
023300,2574,3461,3828,9863,023300,0.2609753624657812,0.3509074318158775,0.3881172057183413,5
023301,494,756,437,1687,023301,0.2928275044457617,0.44813278008298757,0.25903971547125076,4
023302,411,590,323,1324,023302,0.3104229607250755,0.44561933534743203,0.24395770392749244,1
023400,1769,1995,2165,5929,023400,0.29836397368864903,0.3364817001180638,0.36515432619328725,5
023401,807,951,1542,3300,023401,0.24454545454545454,0.2881818181818182,0.4672727272727273,6
023402,580,631,992,2203,023402,0.2632773490694508,0.2864275987290059,0.45029505220154337,6
023404,654,800,1148,2602,023404,0.2513451191391238,0.3074558032282859,0.4411990776325903,5
023405,519,814,604,1937,023405,0.2679401135776975,0.4202374806401652,0.3118224057821373,5
023500,1636,2144,2155,5935,023500,0.27565290648694185,0.3612468407750632,0.36310025273799496,5
023501,1295,1908,1901,5104,023501,0.25372257053291536,0.3738244514106583,0.37245297805642635,5
023502,1391,1710,1871,4972,023502,0.27976669348350763,0.34392598551890585,0.37630732099758646,5
023600,2293,2763,2578,7634,023600,0.30036678019386953,0.36193345559339796,0.3376997642127325,3
023700,1149,1414,1383,3946,023700,0.29118094272681194,0.35833755701976683,0.3504815002534212,5
023702,535,827,860,2222,023702,0.24077407740774076,0.37218721872187216,0.387038703870387,5
023703,521,868,466,1855,023703,0.28086253369272235,0.4679245283018868,0.25121293800539085,4
023704,420,695,337,1452,023704,0.2892561983471074,0.4786501377410468,0.23209366391184574,4
023800,1699,2195,1885,5779,023800,0.2939955009517218,0.3798234988752379,0.3261810001730403,5
023801,582,681,2367,3630,023801,0.16033057851239668,0.18760330578512396,0.6520661157024793,6
023802,117,159,666,942,023802,0.12420382165605096,0.16878980891719744,0.7070063694267515,6
023900,1545,2287,1695,5527,023900,0.27953681925094986,0.4137868644834449,0.3066763162656052,5
023901,819,1074,1312,3205,023901,0.25553822152886113,0.33510140405616223,0.4093603744149766,5
023902,871,1169,1542,3582,023902,0.2431602456728085,0.32635399218313793,0.4304857621440536,5
024000,1957,2614,2499,7070,024000,0.2768033946251768,0.3697312588401697,0.35346534653465345,5
024001,680,1008,1240,2928,024001,0.23224043715846995,0.3442622950819672,0.42349726775956287,5
024002,207,370,315,892,024002,0.2320627802690583,0.4147982062780269,0.3531390134529148,5
024100,2007,2607,2669,7283,024100,0.27557325278044764,0.35795688589866814,0.36646986132088427,5
024101,582,858,1021,2461,024101,0.23648923201950425,0.34863876472978467,0.4148720032507111,5
024102,637,965,968,2570,024102,0.24785992217898833,0.3754863813229572,0.37665369649805447,5
024200,1232,1593,1533,4358,024200,0.2826984855438274,0.36553464892152365,0.3517668655346489,5
024201,788,1081,1201,3070,024201,0.25667752442996744,0.3521172638436482,0.39120521172638434,5
024202,347,389,499,1235,024202,0.28097165991902834,0.31497975708502024,0.4040485829959514,5
024300,1505,2289,2365,6159,024300,0.24435785030037344,0.37165124208475403,0.38399090761487253,5
024301,977,1319,1500,3796,024301,0.25737618545837726,0.34747102212855635,0.3951527924130664,5
024302,1609,2189,2094,5892,024302,0.27308214528173796,0.371520706042091,0.35539714867617106,5
024303,977,1287,1782,4046,024303,0.24147305981216016,0.3180919426594167,0.44043499752842313,5
024400,887,1290,1365,3542,024400,0.25042348955392435,0.3642010163749294,0.38537549407114624,5
024401,826,977,1945,3748,024401,0.22038420490928495,0.26067235859124865,0.5189434364994664,6
024402,392,443,1080,1915,024402,0.20469973890339427,0.23133159268929504,0.5639686684073107,6
024404,514,630,1118,2262,024404,0.22723253757736517,0.27851458885941643,0.4942528735632184,6
024405,653,740,1210,2603,024405,0.250864387245486,0.28428736073761046,0.46484825201690355,6
024406,311,354,510,1175,024406,0.26468085106382977,0.30127659574468085,0.4340425531914894,5
024500,3015,4466,4834,12315,024500,0.24482338611449453,0.36264717823792125,0.39252943564758425,5
024501,770,1180,988,2938,024501,0.2620830496936692,0.4016337644656229,0.336283185840708,5
024502,912,1152,1116,3180,024502,0.28679245283018867,0.3622641509433962,0.35094339622641507,5
024600,1024,1380,1823,4227,024600,0.2422521883132245,0.32647267565649396,0.4312751360302815,5
024700,1768,2434,2901,7103,024700,0.24890891172743912,0.3426721103758975,0.40841897789666337,5
024800,962,1261,2257,4480,024800,0.21473214285714284,0.2814732142857143,0.5037946428571428,6
024900,1080,1591,2434,5105,024900,0.21155729676787463,0.3116552399608227,0.47678746327130267,5
025000,421,544,719,1684,025000,0.25,0.32304038004750596,0.42695961995249404,5
025001,376,427,656,1459,025001,0.2577107607950651,0.29266620973269364,0.44962302947224125,6
025002,500,495,907,1902,025002,0.2628811777076761,0.26025236593059936,0.4768664563617245,6
025003,246,218,425,889,025003,0.27671541057367827,0.2452193475815523,0.4780652418447694,6
025100,2633,3722,4720,11075,025100,0.23774266365688487,0.3360722347629797,0.42618510158013545,5
025200,1265,1630,1912,4807,025200,0.2631578947368421,0.33908882879134594,0.39775327647181197,5
025300,3045,3947,4502,11494,025300,0.26492082825822166,0.34339655472420394,0.3916826170175744,5
025301,496,654,1260,2410,025301,0.20580912863070538,0.2713692946058091,0.5228215767634855,6
025302,339,443,685,1467,025302,0.2310838445807771,0.3019768234492161,0.4669393319700068,5
025400,1905,2681,3184,7770,025400,0.24517374517374518,0.345045045045045,0.4097812097812098,5
025500,2753,3688,3689,10130,025500,0.2717670286278381,0.36406712734452124,0.3641658440276407,5
025600,915,1303,1500,3718,025600,0.2461000537923615,0.35045723507261967,0.40344271113501884,5
025700,1408,1957,2721,6086,025700,0.23135064081498521,0.3215576733486691,0.44709168583634573,5
025800,797,1257,1177,3231,025800,0.24667285670071185,0.38904363974001854,0.3642835035592696,5
025900,848,1085,1628,3561,025900,0.2381353552372929,0.30468969390620615,0.457174950856501,5
025901,213,355,410,978,025901,0.21779141104294478,0.36298568507157464,0.41922290388548056,5
025902,385,482,290,1157,025902,0.3327571305099395,0.41659464131374246,0.25064822817631804,1
026000,662,884,831,2377,026000,0.278502313840976,0.37189734960033655,0.34960033655868744,5
026100,2980,4363,3948,11291,026100,0.26392702152156583,0.38641395801966166,0.34965902045877245,5
026200,1057,1370,1837,4264,026200,0.24788930581613508,0.32129455909943716,0.4308161350844278,5
026300,2715,4013,3423,10151,026300,0.2674613338587331,0.39533050930942765,0.33720815683183925,5
026400,1633,2532,2446,6611,026400,0.24701255483285434,0.3829980335803963,0.36998941158674936,5
026500,2500,3305,3607,9412,026500,0.2656183595410115,0.35114747131321716,0.38323416914577135,5
026600,614,773,777,2164,026600,0.28373382624768945,0.3572088724584104,0.3590573012939002,5
026601,288,381,794,1463,026601,0.19685577580314423,0.2604237867395762,0.5427204374572796,6
026602,457,672,1332,2461,026602,0.18569687119057293,0.2730597318163348,0.5412433969930922,6
026700,1817,2626,2699,7142,026700,0.2544105292635116,0.36768412209465134,0.377905348641837,5
026701,346,590,586,1522,026701,0.22733245729303547,0.3876478318002628,0.38501971090670173,5
026702,643,925,1041,2609,026702,0.2464545802989651,0.3545419701034879,0.39900344959754697,5
026800,451,591,608,1650,026800,0.2733333333333333,0.35818181818181816,0.36848484848484847,5
026900,1547,2265,1956,5768,026900,0.2682038834951456,0.39268377253814146,0.3391123439667129,5
026901,492,786,623,1901,026901,0.25881115202524985,0.4134665965281431,0.32772225144660705,5
026902,541,639,666,1846,026902,0.2930660888407367,0.34615384615384615,0.3607800650054171,5
027000,492,559,678,1729,027000,0.28455754771544245,0.3233082706766917,0.39213418160786584,5
027100,2099,3019,3087,8205,027100,0.2558196221815966,0.3679463741620963,0.3762340036563071,5
027200,533,784,732,2049,027200,0.2601268911664226,0.3826256710590532,0.35724743777452417,5
027300,2461,3446,4691,10598,027300,0.2322136252123042,0.3251556897527835,0.44263068503491226,5
027301,365,444,943,1752,027301,0.20833333333333334,0.2534246575342466,0.53824200913242,6
027302,318,362,790,1470,027302,0.2163265306122449,0.24625850340136055,0.5374149659863946,6
027400,505,677,732,1914,027400,0.26384535005224663,0.35370950888192265,0.3824451410658307,5
027401,371,502,1176,2049,027401,0.1810639336261591,0.2449975597852611,0.5739385065885798,6
027402,275,308,796,1379,027402,0.1994198694706309,0.2233502538071066,0.5772298767222626,6
027500,1363,1769,2860,5992,027500,0.22746995994659547,0.29522696929238984,0.4773030707610147,6
027600,641,832,731,2204,027600,0.2908348457350272,0.37749546279491836,0.33166969147005443,5
027700,2280,3544,3242,9066,027700,0.2514890800794176,0.39091109640414734,0.35759982351643504,5
027702,581,657,1399,2637,027702,0.22032612817595754,0.24914675767918087,0.5305271141448615,6
027704,383,477,884,1744,027704,0.21961009174311927,0.2735091743119266,0.5068807339449541,6
027705,526,645,1113,2284,027705,0.23029772329246936,0.28239929947460596,0.4873029772329247,6
027706,307,340,691,1338,027706,0.22944693572496264,0.25411061285500747,0.5164424514200299,6
027800,560,743,808,2111,027800,0.26527711984841307,0.35196589294173375,0.38275698720985313,5
027900,2754,4080,5427,12261,027900,0.2246146317592366,0.33276241742109125,0.4426229508196721,5
028000,343,460,593,1396,028000,0.24570200573065903,0.32951289398280803,0.42478510028653294,5
028100,1712,2424,3746,7882,028100,0.2172037553920325,0.30753615833544784,0.47526008627251964,5
028200,427,622,789,1838,028200,0.2323177366702938,0.338411316648531,0.4292709466811752,5
028300,2341,3365,3877,9583,028300,0.24428675780027131,0.35114264843994575,0.40457059375978294,5
028400,799,1175,1149,3123,028400,0.2558437399935959,0.37624079410822925,0.3679154658981748,5
028500,1519,2241,3235,6995,028500,0.21715511079342387,0.32037169406719085,0.4624731951393853,5
028501,96,116,142,354,028501,0.2711864406779661,0.327683615819209,0.4011299435028249,5
028502,282,530,309,1121,028502,0.25156110615521854,0.4727921498661909,0.27564674397859057,4
028600,618,819,1050,2487,028600,0.24849215922798554,0.3293124246079614,0.4221954161640531,5
028700,1809,2580,3461,7850,028700,0.23044585987261146,0.3286624203821656,0.44089171974522295,5
028800,1004,1440,1747,4191,028800,0.2395609639704128,0.3435934144595562,0.416845621570031,5
028900,1283,1827,2463,5573,028900,0.2302171182486991,0.3278306118787009,0.44195226987260006,5
029000,392,578,648,1618,029000,0.242274412855377,0.3572311495673671,0.4004944375772559,5
029100,2057,3141,3012,8210,029100,0.2505481120584653,0.3825822168087698,0.3668696711327649,5
029102,260,388,736,1384,029102,0.18786127167630057,0.28034682080924855,0.5317919075144508,6
029103,589,764,1504,2857,029103,0.20616030801540078,0.26741337066853343,0.5264263213160658,6
029104,586,812,1472,2870,029104,0.20418118466898955,0.28292682926829266,0.5128919860627178,6
029200,224,365,371,960,029200,0.23333333333333334,0.3802083333333333,0.38645833333333335,5
029300,1403,2153,1752,5308,029300,0.26431801055011306,0.4056141672946496,0.3300678221552374,5
029301,173,178,553,904,029301,0.1913716814159292,0.19690265486725664,0.6117256637168141,6
029302,377,471,1399,2247,029302,0.16777926123720516,0.2096128170894526,0.6226079216733422,6
029400,691,1187,1347,3225,029400,0.21426356589147286,0.36806201550387596,0.41767441860465115,5
029500,2001,2416,4891,9308,029500,0.2149763644177052,0.25956166738289643,0.5254619681993984,6
029600,767,1241,1454,3462,029600,0.22154823801270943,0.3584633160023108,0.4199884459849798,5
029700,1047,1193,2291,4531,029700,0.23107481792098875,0.26329728536746855,0.5056278967115427,6
029800,361,474,556,1391,029800,0.2595255212077642,0.3407620416966211,0.39971243709561466,5
029900,716,1130,898,2744,029900,0.260932944606414,0.41180758017492713,0.3272594752186589,5
030000,1371,1730,2897,5998,030000,0.22857619206402133,0.28842947649216405,0.4829943314438146,6
030100,1443,1899,2025,5367,030100,0.2688652878703186,0.3538289547233091,0.3773057574063723,5
030200,1671,2395,3270,7336,030200,0.22778080697928027,0.3264721919302072,0.4457470010905125,5
030201,475,656,797,1928,030201,0.24636929460580914,0.34024896265560167,0.4133817427385892,5
030202,739,838,1319,2896,030202,0.25517955801104975,0.2893646408839779,0.45545580110497236,6
030300,1758,2184,2473,6415,030300,0.2740452065471551,0.34045206547155105,0.38550272798129387,5
030301,455,629,1035,2119,030301,0.2147239263803681,0.2968381311939594,0.4884379424256725,6
030302,594,812,1329,2735,030302,0.21718464351005484,0.2968921389396709,0.48592321755027423,6
030400,1279,1613,1803,4695,030400,0.2724174653887114,0.3435569755058573,0.3840255591054313,5
030500,1163,1557,2304,5024,030500,0.2314888535031847,0.3099124203821656,0.4585987261146497,5
030501,307,301,580,1188,030501,0.25841750841750843,0.25336700336700335,0.4882154882154882,6
030502,417,414,835,1666,030502,0.2503001200480192,0.24849939975990396,0.5012004801920769,6
030600,1591,2168,2378,6137,030600,0.2592471891803813,0.3532670686002933,0.3874857422193254,5
030700,3032,3850,4912,11794,030700,0.2570798711209089,0.3264371714431067,0.4164829574359844,5
030701,424,511,1490,2425,030701,0.17484536082474228,0.2107216494845361,0.6144329896907217,6
030800,1738,2377,2470,6585,030800,0.2639331814730448,0.3609719058466211,0.37509491268033407,5
030900,1815,2502,3113,7430,030900,0.24427994616419918,0.336742934051144,0.4189771197846568,5
030902,662,938,1092,2692,030902,0.24591381872213966,0.34843982169390786,0.40564635958395245,5
030903,538,861,921,2320,030903,0.23189655172413792,0.3711206896551724,0.39698275862068966,5
030904,350,458,611,1419,030904,0.24665257223396758,0.3227625088090204,0.43058491895701195,5
031000,963,1338,1821,4122,031000,0.2336244541484716,0.3245997088791849,0.4417758369723435,5
031100,1190,1612,1875,4677,031100,0.25443660466110757,0.34466538379302974,0.40089801154586274,5
031200,491,785,1035,2311,031200,0.21246213760276936,0.3396797922977066,0.447858070099524,5
031300,941,1399,1669,4009,031300,0.23472187577949613,0.3489648291344475,0.41631329508605636,5
031400,1188,1523,1827,4538,031400,0.2617893345085941,0.3356104010577347,0.4026002644336712,5
031500,606,886,1170,2662,031500,0.22764838467317805,0.33283245679939893,0.439519158527423,5
031600,177,231,388,796,031600,0.22236180904522612,0.29020100502512564,0.48743718592964824,6
031700,456,621,1341,2418,031700,0.18858560794044665,0.25682382133995035,0.5545905707196029,6
031701,453,596,873,1922,031701,0.2356919875130073,0.3100936524453694,0.4542143600416233,5
031702,402,549,875,1826,031702,0.22015334063526834,0.30065717415115006,0.4791894852135816,5
031703,374,388,3130,3892,031703,0.09609455292908531,0.09969167523124357,0.8042137718396711,6
031704,332,393,2784,3509,031704,0.09461385009974352,0.11199772014819037,0.7933884297520661,6
031800,147,228,374,749,031800,0.19626168224299065,0.30440587449933243,0.4993324432576769,5
031900,1366,1631,2906,5903,031900,0.23140775876672878,0.2763001863459258,0.4922920548873454,6
031901,356,529,420,1305,031901,0.2727969348659004,0.4053639846743295,0.3218390804597701,5
031902,545,724,649,1918,031902,0.2841501564129301,0.37747653806047965,0.3383733055265902,5
032000,978,1342,2366,4686,032000,0.2087067861715749,0.2863849765258216,0.5049082373026035,6
032100,569,957,1066,2592,032100,0.2195216049382716,0.36921296296296297,0.4112654320987654,5
032101,542,472,1784,2798,032101,0.1937097927090779,0.16869192280200143,0.6375982844889206,6
032102,230,164,569,963,032102,0.23883696780893043,0.1703011422637591,0.5908618899273105,6
032200,568,799,1132,2499,032200,0.2272909163665466,0.3197278911564626,0.4529811924769908,5
032300,1330,1805,2936,6071,032300,0.21907428759677153,0.2973151045956185,0.48361060780760995,6
032400,268,410,460,1138,032400,0.23550087873462214,0.3602811950790861,0.40421792618629176,5
032402,333,321,797,1451,032402,0.22949689869055823,0.22122674017918678,0.549276361130255,6
032403,265,373,612,1250,032403,0.212,0.2984,0.4896,6
032404,704,855,1803,3362,032404,0.20939916716240334,0.2543129089827484,0.5362879238548484,6
032500,770,1105,1148,3023,032500,0.25471386040357263,0.36553092954019184,0.3797552100562355,5
032502,429,467,951,1847,032502,0.23226854358419058,0.25284244721169463,0.5148890092041147,6
032503,493,497,1137,2127,032503,0.231781852374236,0.23366243535496004,0.5345557122708039,6
032504,219,330,655,1204,032504,0.1818936877076412,0.27408637873754155,0.5440199335548173,6
032600,954,1289,1269,3512,032600,0.2716400911161731,0.3670273348519362,0.3613325740318907,5
032601,255,305,635,1195,032601,0.21338912133891214,0.25523012552301255,0.5313807531380753,6
032602,448,617,1039,2104,032602,0.21292775665399238,0.29325095057034223,0.4938212927756654,6
032700,1122,1623,2008,4753,032700,0.23606143488323164,0.34146854618135913,0.4224700189354092,5
032800,939,1417,1523,3879,032800,0.24207269914926527,0.36530033513792215,0.3926269657128126,5
032900,923,1520,1603,4046,032900,0.22812654473554128,0.3756796836381611,0.3961937716262976,5
032901,474,662,976,2112,032901,0.22443181818181818,0.3134469696969697,0.4621212121212121,5
032902,530,713,1141,2384,032902,0.22231543624161074,0.2990771812080537,0.4786073825503356,6
033000,1441,2399,2433,6273,033000,0.22971465008767736,0.3824326478558903,0.38785270205643235,5
033002,337,337,718,1392,033002,0.24209770114942528,0.24209770114942528,0.5158045977011494,6
033003,471,533,945,1949,033003,0.24166239096972805,0.27347357619291945,0.48486403283735247,6
033004,366,497,752,1615,033004,0.22662538699690402,0.3077399380804954,0.46563467492260063,5
033100,551,815,693,2059,033100,0.2676056338028169,0.3958232151529869,0.3365711510441962,5
033101,244,304,571,1119,033101,0.21805183199285075,0.2716711349419124,0.5102770330652369,6
033102,634,799,1487,2920,033102,0.21712328767123287,0.27363013698630134,0.5092465753424658,6
033200,449,606,571,1626,033200,0.27613776137761376,0.3726937269372694,0.35116851168511687,5
033201,305,481,771,1557,033201,0.19588953114964675,0.30892742453436095,0.4951830443159923,5
033202,322,550,692,1564,033202,0.20588235294117646,0.3516624040920716,0.4424552429667519,5
033300,731,1011,1131,2873,033300,0.25443786982248523,0.35189697180647406,0.3936651583710407,5
033400,411,493,525,1429,033400,0.28761371588523443,0.3449965010496851,0.36738978306508047,5
033401,238,549,518,1305,033401,0.18237547892720307,0.4206896551724138,0.3969348659003831,5
033402,1036,1747,1932,4715,033402,0.21972428419936374,0.3705196182396607,0.4097560975609756,5
033500,848,1024,1450,3322,033500,0.25526791089705,0.3082480433473811,0.43648404575556893,5
033600,851,1390,1465,3706,033600,0.22962763086886132,0.3750674581759309,0.39530491095520776,5
033700,924,1373,1801,4098,033700,0.22547584187408493,0.33504148365056124,0.43948267447535383,5
033800,375,585,586,1546,033800,0.2425614489003881,0.3783958602846054,0.37904269081500647,5
033900,689,1063,1252,3004,033900,0.22936085219707059,0.35386151797603194,0.4167776298268975,5
034000,597,986,918,2501,034000,0.2387045181927229,0.3942423030787685,0.3670531787285086,5
034100,289,382,585,1256,034100,0.2300955414012739,0.304140127388535,0.46576433121019106,5
034200,885,1279,961,3125,034200,0.2832,0.40928,0.30752,5
034300,683,1047,1009,2739,034300,0.24936108068638188,0.3822562979189485,0.3683826213946696,5
034400,150,219,328,697,034400,0.2152080344332855,0.31420373027259685,0.47058823529411764,5
034500,541,719,1329,2589,034500,0.208960988798764,0.2777134028582464,0.5133256083429896,6
034700,664,965,892,2521,034700,0.26338754462514874,0.38278460928203095,0.3538278460928203,5
034800,728,1039,1173,2940,034800,0.24761904761904763,0.35340136054421767,0.3989795918367347,5
034900,568,916,752,2236,034900,0.25402504472271914,0.40966010733452596,0.3363148479427549,5
035000,550,779,914,2243,035000,0.24520731163620152,0.34730271957200176,0.4074899687917967,5
035100,1480,2250,2576,6306,035100,0.23469711385981604,0.35680304471931495,0.40849984142086904,5
035200,319,504,492,1315,035200,0.24258555133079848,0.3832699619771863,0.3741444866920152,5
035300,1129,1559,1541,4229,035300,0.26696618585954124,0.3686450697564436,0.36438874438401514,5
035400,857,1235,1287,3379,035400,0.2536253329387393,0.3654927493341225,0.3808819177271382,5
035500,809,1271,1128,3208,035500,0.25218204488778057,0.39619700748129677,0.3516209476309227,5
035600,612,855,753,2220,035600,0.2756756756756757,0.38513513513513514,0.33918918918918917,5
035601,307,461,567,1335,035601,0.2299625468164794,0.3453183520599251,0.4247191011235955,5
035602,498,719,990,2207,035602,0.22564567285908474,0.3257816039873131,0.4485727231536022,5
035700,1017,1510,1441,3968,035700,0.25630040322580644,0.3805443548387097,0.3631552419354839,5
035800,1411,2106,2404,5921,035800,0.2383043404830265,0.3556831616281034,0.4060124978888701,5
035900,809,1199,926,2934,035900,0.27573278800272666,0.40865712338104976,0.3156100886162236,5
035901,535,552,688,1775,035901,0.30140845070422534,0.31098591549295773,0.38760563380281693,3
035902,101,100,118,319,035902,0.3166144200626959,0.31347962382445144,0.36990595611285265,3
036000,707,985,1217,2909,036000,0.24303884496390513,0.3386043313853558,0.41835682365073906,5
036001,344,452,420,1216,036001,0.28289473684210525,0.3717105263157895,0.34539473684210525,5
036002,436,621,485,1542,036002,0.2827496757457847,0.4027237354085603,0.314526588845655,5
036100,1688,2292,1906,5886,036100,0.28678219503907576,0.3893985728848114,0.3238192320761128,5
036200,397,540,448,1385,036200,0.28664259927797836,0.3898916967509025,0.3234657039711191,5
036300,1849,2601,2041,6491,036300,0.2848559543983978,0.4007086735479895,0.3144353720536127,5
036400,541,755,683,1979,036400,0.2733703890853967,0.3815058110156645,0.3451237998989389,5
036401,335,399,401,1135,036401,0.29515418502202645,0.3515418502202643,0.35330396475770925,5
036402,391,476,519,1386,036402,0.2821067821067821,0.3434343434343434,0.37445887445887444,5
036500,899,1218,998,3115,036500,0.28860353130016053,0.39101123595505616,0.3203852327447833,5
036501,620,1114,838,2572,036501,0.2410575427682737,0.4331259720062208,0.32581648522550544,5
036502,425,681,414,1520,036502,0.27960526315789475,0.44802631578947366,0.2723684210526316,4
036600,1007,1378,1345,3730,036600,0.26997319034852546,0.36943699731903484,0.3605898123324397,5
036700,1210,1691,1411,4312,036700,0.28061224489795916,0.39216141001855287,0.32722634508348797,5
036800,942,1285,1421,3648,036800,0.2582236842105263,0.3522478070175439,0.38952850877192985,5
036900,530,846,542,1918,036900,0.27632950990615224,0.4410844629822732,0.28258602711157454,4
036901,546,701,648,1895,036901,0.28812664907651714,0.36992084432717676,0.34195250659630605,5
036902,654,808,764,2226,036902,0.29380053908355797,0.36298292902066487,0.34321653189577717,5
037000,983,1335,1838,4156,037000,0.23652550529355149,0.3212223291626564,0.4422521655437921,5
037100,1482,2237,2134,5853,037100,0.25320348539210663,0.3821971638475995,0.36459935076029387,5
037200,670,890,906,2466,037200,0.27169505271695055,0.3609083536090835,0.36739659367396593,5
037300,1803,2804,2161,6768,037300,0.26640070921985815,0.41430260047281325,0.3192966903073286,5
037400,794,1229,1012,3035,037400,0.2616144975288303,0.40494233937397034,0.33344316309719935,5
037401,339,545,716,1600,037401,0.211875,0.340625,0.4475,5
037402,392,555,659,1606,037402,0.24408468244084683,0.3455790784557908,0.41033623910336237,5
037500,1295,1758,1684,4737,037500,0.27337977622968124,0.37112096263457883,0.35549926113573993,5
037504,365,602,357,1324,037504,0.2756797583081571,0.45468277945619334,0.26963746223564955,4
037600,930,1502,1605,4037,037600,0.230369085954917,0.3720584592519197,0.3975724547931632,5
037700,571,999,1025,2595,037700,0.22003853564547207,0.38497109826589593,0.394990366088632,5
037800,260,500,413,1173,037800,0.2216538789428815,0.42625745950554134,0.35208866155157714,5
037900,1352,2130,1476,4958,037900,0.27269060104881,0.42960871319080274,0.2977006857603873,4
038000,438,630,611,1679,038000,0.2608695652173913,0.37522334723049433,0.36390708755211437,5
038100,1678,2659,1862,6199,038100,0.27068882077754475,0.4289401516373609,0.3003710275850944,5
038200,882,1212,948,3042,038200,0.28994082840236685,0.398422090729783,0.3116370808678501,5
038300,359,560,648,1567,038300,0.22910019144862795,0.3573707721761327,0.4135290363752393,5
038301,617,955,524,2096,038301,0.2943702290076336,0.4556297709923664,0.25,4
038302,769,1050,607,2426,038302,0.31698268755152514,0.43281121187139326,0.2502061005770816,1
038400,240,396,425,1061,038400,0.22620169651272384,0.37323279924599434,0.4005655042412818,5
038500,835,1149,947,2931,038500,0.28488570453770046,0.39201637666325484,0.3230979187990447,5
038600,1073,1645,1539,4257,038600,0.25205543810194975,0.3864223631665492,0.36152219873150104,5
038700,706,1122,931,2759,038700,0.2558898151504168,0.40666908300108734,0.33744110184849585,5
038800,532,836,990,2358,038800,0.22561492790500423,0.35453774385072095,0.4198473282442748,5
038900,919,1309,984,3212,038900,0.2861145703611457,0.4075342465753425,0.30635118306351183,5
039000,444,755,798,1997,039000,0.22233350025037557,0.3780671006509765,0.39959939909864794,5
039100,1060,1603,1170,3833,039100,0.2765457865901383,0.4182102791547091,0.3052439342551526,5
039200,453,626,699,1778,039200,0.2547806524184477,0.35208098987626546,0.3931383577052868,5
039300,1273,1910,1263,4446,039300,0.2863247863247863,0.4295996401259559,0.2840755735492578,4
039400,848,1465,1365,3678,039400,0.23056008700380642,0.39831430125067974,0.37112561174551384,5
039500,769,1236,853,2858,039500,0.26906927921623514,0.4324702589223233,0.2984604618614416,4
039600,476,827,792,2095,039600,0.22720763723150358,0.3947494033412888,0.3780429594272076,5
039700,873,1189,887,2949,039700,0.2960325534079349,0.40318752119362494,0.3007799253984402,5
039800,698,1106,1097,2901,039800,0.24060668734918994,0.38124784557049296,0.37814546708031715,5
039900,741,1089,909,2739,039900,0.27053669222343923,0.39759036144578314,0.33187294633077763,5
039901,472,783,479,1734,039901,0.2722029988465975,0.4515570934256055,0.276239907727797,4
039902,474,808,476,1758,039902,0.2696245733788396,0.459613196814562,0.2707622298065984,4
040000,441,592,617,1650,040000,0.2672727272727273,0.35878787878787877,0.37393939393939396,5
040001,409,596,808,1813,040001,0.22559293987865417,0.3287369001654716,0.4456701599558742,5
040003,336,439,731,1506,040003,0.22310756972111553,0.2915006640106242,0.4853917662682603,6
040100,2373,3523,2902,8798,040100,0.2697203909979541,0.4004319163446238,0.32984769265742214,5
040200,1782,2519,2796,7097,040200,0.2510920107087502,0.3549387064957024,0.39396928279554744,5
040300,2035,3027,2534,7596,040300,0.2679041600842549,0.39849921011058453,0.33359662980516064,5
040302,442,689,400,1531,040302,0.28870019595035923,0.45003265839320705,0.2612671456564337,4
040303,429,694,634,1757,040303,0.24416619237336368,0.39499146272054636,0.3608423449060899,5
040304,326,572,518,1416,040304,0.23022598870056496,0.403954802259887,0.365819209039548,5
040400,2157,3153,3003,8313,040400,0.2594731143991339,0.3792854565138939,0.3612414290869722,5
040500,1430,1996,1867,5293,040500,0.2701681466087285,0.37710183260910635,0.35273002078216514,5
040501,421,648,407,1476,040501,0.28523035230352306,0.43902439024390244,0.2757452574525745,4
040502,636,1039,730,2405,040502,0.26444906444906446,0.43201663201663204,0.30353430353430355,5
040600,1941,2811,3040,7792,040600,0.24910164271047228,0.3607546201232033,0.39014373716632444,5
040700,2256,3193,2882,8331,040700,0.2707958228303925,0.38326731484815746,0.34593686232145,5
040701,312,513,476,1301,040701,0.23981552651806304,0.3943120676402767,0.36587240584166025,5
040702,673,1093,741,2507,040702,0.26844834463502193,0.4359792580773833,0.2955723972875947,4
040800,1439,2160,2151,5750,040800,0.25026086956521737,0.37565217391304345,0.3740869565217391,5
040801,518,794,860,2172,040801,0.23848987108655617,0.36556169429097607,0.39594843462246776,5
040802,439,699,625,1763,040802,0.24900737379466817,0.396483267158253,0.35450935904707886,5
040900,1902,2923,2844,7669,040900,0.2480114747685487,0.3811448689529274,0.37084365627852395,5
041000,1194,1633,1807,4634,041000,0.25766076823478634,0.35239533880017265,0.389943892965041,5
041100,2211,3008,3208,8427,041100,0.2623709505161979,0.3569479055417112,0.3806811439420909,5
041200,1148,1722,2180,5050,041200,0.22732673267326733,0.340990099009901,0.4316831683168317,5
041300,2480,3333,3382,9195,041300,0.2697117998912452,0.36247960848287114,0.36780859162588364,5
041400,1716,2761,2893,7370,041400,0.23283582089552238,0.3746268656716418,0.3925373134328358,5
041401,117,177,246,540,041401,0.21666666666666667,0.3277777777777778,0.45555555555555555,5
041402,155,288,264,707,041402,0.21923620933521923,0.4073550212164074,0.3734087694483734,5
041500,1745,2559,2296,6600,041500,0.2643939393939394,0.38772727272727275,0.3478787878787879,5
041600,554,699,859,2112,041600,0.2623106060606061,0.3309659090909091,0.40672348484848486,5
041700,795,1239,1294,3328,041700,0.23888221153846154,0.3722956730769231,0.38882211538461536,5
041800,1085,1583,1512,4180,041800,0.2595693779904306,0.3787081339712919,0.3617224880382775,5
041900,1022,1715,1364,4101,041900,0.24920751036332603,0.41819068519873204,0.33260180443794196,5
042000,583,935,898,2416,042000,0.24130794701986755,0.38700331125827814,0.3716887417218543,5
042100,1405,1997,1925,5327,042100,0.2637507039609536,0.3748826731743946,0.36136662286465177,5
042200,615,883,1038,2536,042200,0.24250788643533122,0.34818611987381703,0.40930599369085174,5
042300,877,1292,1220,3389,042300,0.2587784007081735,0.38123340218353496,0.35998819710829155,5
042400,902,1270,1355,3527,042400,0.2557414233059257,0.36007938758151403,0.38417918911256027,5
042500,1085,1558,1313,3956,042500,0.2742669362992922,0.39383215369059654,0.33190091001011124,5
042600,1101,1636,1696,4433,042600,0.24836453868711933,0.3690503045341755,0.3825851567787052,5
042700,915,1484,1445,3844,042700,0.23803329864724246,0.38605619146722164,0.3759105098855359,5
042800,611,989,1081,2681,042800,0.2279000372995151,0.3688922044013428,0.4032077582991421,5
042900,554,835,854,2243,042900,0.24699063753901027,0.3722692822113241,0.3807400802496656,5
042901,379,539,466,1384,042901,0.2738439306358382,0.38945086705202314,0.33670520231213874,5
042902,422,650,522,1594,042902,0.26474278544542035,0.4077791718946048,0.32747804265997493,5
043000,693,960,968,2621,043000,0.2644028996566196,0.36627241510873715,0.3693246852346433,5
043100,1461,2216,1845,5522,043100,0.26457805143064106,0.40130387540746104,0.33411807316189784,5
043200,586,726,822,2134,043200,0.274601686972821,0.3402061855670103,0.3851921274601687,5
043300,366,583,545,1494,043300,0.24497991967871485,0.39022757697456495,0.3647925033467202,5
043400,906,1457,1357,3720,043400,0.2435483870967742,0.39166666666666666,0.36478494623655916,5
043500,513,796,654,1963,043500,0.26133469179826796,0.4055017829852267,0.33316352521650533,5
043600,642,994,941,2577,043600,0.24912689173457508,0.3857198292588281,0.36515327900659683,5
043700,551,826,699,2076,043700,0.26541425818882464,0.3978805394990366,0.33670520231213874,5
043701,323,476,407,1206,043701,0.2678275290215589,0.3946932006633499,0.33747927031509123,5
043702,531,983,884,2398,043702,0.22143452877397832,0.4099249374478732,0.3686405337781485,5
043800,233,306,386,925,043800,0.2518918918918919,0.3308108108108108,0.4172972972972973,5
043900,720,1129,987,2836,043900,0.2538787023977433,0.3980959097320169,0.3480253878702398,5
044000,595,879,932,2406,044000,0.24729842061512886,0.3653366583541147,0.3873649210307564,5
044100,492,777,725,1994,044100,0.24674022066198595,0.38966900702106316,0.36359077231695086,5
044200,524,827,845,2196,044200,0.23861566484517305,0.37659380692167577,0.3847905282331512,5
044300,451,762,797,2010,044300,0.2243781094527363,0.37910447761194027,0.3965174129353234,5
044301,343,546,439,1328,044301,0.2582831325301205,0.411144578313253,0.3305722891566265,5
044302,527,685,614,1826,044302,0.28860898138006574,0.37513691128148957,0.3362541073384447,5
044400,922,1421,1478,3821,044400,0.24129808950536508,0.3718921748233447,0.38680973567129023,5
044500,458,620,862,1940,044500,0.23608247422680412,0.31958762886597936,0.44432989690721647,5
044600,253,239,322,814,044600,0.3108108108108108,0.2936117936117936,0.3955773955773956,2
044601,327,513,372,1212,044601,0.2698019801980198,0.42326732673267325,0.3069306930693069,5
044602,463,722,499,1684,044602,0.2749406175771972,0.42874109263657956,0.29631828978622327,4
044700,257,349,522,1128,044700,0.22783687943262412,0.30939716312056736,0.4627659574468085,5
044800,657,896,1151,2704,044800,0.2429733727810651,0.33136094674556216,0.4256656804733728,5
044900,330,496,524,1350,044900,0.24444444444444444,0.3674074074074074,0.38814814814814813,5
044901,260,335,465,1060,044901,0.24528301886792453,0.3160377358490566,0.4386792452830189,5
044902,252,402,513,1167,044902,0.2159383033419023,0.3444730077120823,0.43958868894601544,5
045000,280,440,532,1252,045000,0.22364217252396165,0.3514376996805112,0.4249201277955272,5
045101,207,278,509,994,045101,0.20824949698189135,0.2796780684104628,0.5120724346076458,6
045102,282,349,568,1199,045102,0.23519599666388658,0.2910758965804837,0.4737281067556297,6
045200,340,449,595,1384,045200,0.24566473988439305,0.32442196531791906,0.42991329479768786,5
045300,304,351,462,1117,045300,0.2721575649059982,0.3142345568487019,0.41360787824529993,5
045400,647,883,982,2512,045400,0.2575636942675159,0.3515127388535032,0.3909235668789809,5
045500,1372,2152,2134,5658,045500,0.24248851184164016,0.3803464121597738,0.37716507599858606,5
045600,717,1099,1261,3077,045600,0.23301917452063697,0.35716607084822877,0.4098147546311342,5
045700,333,535,598,1466,045700,0.2271487039563438,0.36493860845839016,0.40791268758526605,5
045800,943,1348,1405,3696,045800,0.25514069264069267,0.3647186147186147,0.38014069264069267,5
045900,462,635,564,1661,045900,0.2781456953642384,0.3822998193859121,0.3395544852498495,5
046000,1231,1857,1763,4851,046000,0.25376211090496803,0.38280766852195425,0.3634302205730777,5
046100,339,424,353,1116,046100,0.30376344086021506,0.37992831541218636,0.3163082437275986,3
046200,736,1164,937,2837,046200,0.25942897426859357,0.4102925625660909,0.33027846316531545,5
046201,2222,3679,5763,11664,046201,0.19050068587105623,0.3154149519890261,0.4940843621399177,5
046202,916,1329,1747,3992,046202,0.22945891783567135,0.33291583166332667,0.437625250501002,5
046300,429,589,430,1448,046300,0.2962707182320442,0.406767955801105,0.2969613259668508,4
046400,417,495,690,1602,046400,0.2602996254681648,0.3089887640449438,0.4307116104868914,5
046500,306,469,364,1139,046500,0.26865671641791045,0.4117647058823529,0.31957857769973663,5
046600,289,429,727,1445,046600,0.2,0.2968858131487889,0.5031141868512111,6
046700,588,1042,790,2420,046700,0.24297520661157024,0.4305785123966942,0.32644628099173556,5
046800,646,892,802,2340,046800,0.2760683760683761,0.3811965811965812,0.34273504273504274,5
046900,765,1249,1053,3067,046900,0.2494294098467558,0.40723834365829803,0.3433322464949462,5
047000,610,973,727,2310,047000,0.26406926406926406,0.4212121212121212,0.31471861471861473,5
047100,487,574,594,1655,047100,0.29425981873111784,0.3468277945619335,0.35891238670694864,5
047200,692,781,1115,2588,047200,0.26738794435857804,0.3017774343122102,0.43083462132921174,5
047300,508,583,817,1908,047300,0.2662473794549266,0.3055555555555556,0.4281970649895178,5
047400,313,289,268,870,047400,0.35977011494252875,0.332183908045977,0.3080459770114943,3
047500,489,773,870,2132,047500,0.22936210131332083,0.3625703564727955,0.4080675422138837,5
047600,494,518,728,1740,047600,0.28390804597701147,0.29770114942528736,0.41839080459770117,6
047700,371,427,1509,2307,047700,0.16081491114000868,0.18508885999133073,0.6540962288686606,6
047800,931,1309,1503,3743,047800,0.24873096446700507,0.34971947635586426,0.40154955917713064,5
047900,671,768,958,2397,047900,0.27993324989570295,0.32040050062578224,0.3996662494785148,5
048000,695,971,827,2493,048000,0.2787805856397914,0.38949057360609707,0.3317288407541115,5
048100,1107,1345,1686,4138,048100,0.26752054132431125,0.3250362493958434,0.40744320927984534,5
048200,759,1142,1146,3047,048200,0.2490974729241877,0.37479488021004265,0.3761076468657696,5
048300,408,605,651,1664,048300,0.24519230769230768,0.3635817307692308,0.39122596153846156,5
048400,1442,2195,2089,5726,048400,0.25183374083129584,0.3833391547327978,0.3648271044359064,5
048500,893,1232,1554,3679,048500,0.24272900244631693,0.3348736069584126,0.4223973905952704,5
048600,333,424,327,1084,048600,0.30719557195571956,0.39114391143911437,0.3016605166051661,3
048800,438,540,723,1701,048800,0.25749559082892415,0.31746031746031744,0.42504409171075835,5
048900,618,869,605,2092,048900,0.2954110898661568,0.41539196940726575,0.2891969407265774,4
049000,666,908,945,2519,049000,0.2643906312028583,0.36046050019849146,0.37514886859865026,5
049100,734,909,1089,2732,049100,0.2686676427525622,0.3327232796486091,0.3986090775988287,5
049200,839,1254,1524,3617,049200,0.23196018800110588,0.34669615703621787,0.42134365496267623,5
049300,823,1244,1395,3462,049300,0.23772385904101676,0.35932986712882725,0.40294627383015597,5
049301,219,395,487,1101,049301,0.1989100817438692,0.35876475930971846,0.44232515894641233,5
049302,276,447,626,1349,049302,0.20459599703484063,0.3313565604151223,0.46404744255003705,5
049400,488,697,1045,2230,049400,0.21883408071748878,0.3125560538116592,0.46860986547085204,5
049500,483,608,1391,2482,049500,0.19460112812248187,0.24496373892022563,0.5604351329572925,6
049600,738,1138,1362,3238,049600,0.2279184681902409,0.35145151327980234,0.42063001852995674,5
049700,604,817,1832,3253,049700,0.18567476175837688,0.25115278204734093,0.5631724561942822,6
049800,357,514,718,1589,049800,0.22466960352422907,0.3234738829452486,0.45185651353052236,5
049900,794,947,1601,3342,049900,0.23758228605625373,0.28336325553560743,0.4790544584081388,6
050000,896,1248,1659,3803,050000,0.2356034709439916,0.328161977386274,0.4362345516697344,5
050100,268,355,1077,1700,050100,0.15764705882352942,0.2088235294117647,0.6335294117647059,6
050101,428,355,972,1755,050101,0.2438746438746439,0.2022792022792023,0.5538461538461539,6
050102,1669,1621,3437,6727,050102,0.24810465289133343,0.24096922848223576,0.5109261186264308,6
050103,542,578,1316,2436,050103,0.22249589490968802,0.2372742200328407,0.5402298850574713,6
050104,587,631,1489,2707,050104,0.21684521610639085,0.23309937199852235,0.5500554118950868,6
050201,938,1356,1739,4033,050201,0.2325812050582693,0.336226134391272,0.43119266055045874,5
050202,1119,1442,2513,5074,050202,0.22053606621994482,0.2841939298383918,0.4952700039416634,6
050203,529,528,1089,2146,050203,0.24650512581547065,0.24603914259086673,0.5074557315936626,6
050204,246,299,699,1244,050204,0.1977491961414791,0.24035369774919615,0.5618971061093248,6
050205,537,560,1136,2233,050205,0.24048365427675772,0.2507836990595611,0.5087326466636811,6
050300,259,372,1001,1632,050300,0.15870098039215685,0.22794117647058823,0.6133578431372549,6
050301,536,758,863,2157,050301,0.24849327770050997,0.3514140009272137,0.4000927213722763,5
050302,608,857,807,2272,050302,0.2676056338028169,0.3772007042253521,0.355193661971831,5
050400,1561,2152,3138,6851,050400,0.22784994891256752,0.31411472777696686,0.45803532331046565,5
050500,1382,1723,2672,5777,050500,0.2392245109918643,0.29825168772719407,0.46252380128094167,6
050600,707,1129,1206,3042,050600,0.2324128862590401,0.3711374095989481,0.39644970414201186,5
050601,608,655,1262,2525,050601,0.24079207920792078,0.2594059405940594,0.4998019801980198,6
050602,501,662,912,2075,050602,0.24144578313253012,0.31903614457831325,0.4395180722891566,5
050700,616,785,1134,2535,050700,0.24299802761341222,0.3096646942800789,0.44733727810650886,5
050800,581,808,897,2286,050800,0.2541557305336833,0.35345581802274717,0.39238845144356954,5
050801,538,847,622,2007,050801,0.268061783756851,0.42202291978076734,0.30991529646238164,5
050803,333,465,530,1328,050803,0.2507530120481928,0.3501506024096386,0.3990963855421687,5
050804,723,1103,1274,3100,050804,0.2332258064516129,0.35580645161290325,0.41096774193548385,5
050900,833,698,832,2363,050900,0.35251798561151076,0.29538721963605585,0.3520947947524333,2
051000,525,763,735,2023,051000,0.25951557093425603,0.3771626297577855,0.3633217993079585,5
051001,467,861,666,1994,051001,0.2342026078234704,0.4317953861584754,0.3340020060180542,5
051002,511,893,751,2155,051002,0.23712296983758702,0.41438515081206495,0.34849187935034803,5
051100,1077,1440,2152,4669,051100,0.2306703790961662,0.30841721996144783,0.46091240094238595,5
051200,1484,2205,2207,5896,051200,0.25169606512890097,0.3739823609226594,0.3743215739484396,5
051300,1197,1541,3016,5754,051300,0.20802919708029197,0.2678136948209941,0.524157108098714,6
051400,1107,1672,1817,4596,051400,0.24086161879895562,0.3637946040034813,0.3953437771975631,5
051500,1194,1569,2833,5596,051500,0.21336669049320944,0.28037884203002145,0.5062544674767692,6
051600,1838,2557,3464,7859,051600,0.23387199389235272,0.32535946049115666,0.44076854561649065,5
051601,686,984,795,2465,051601,0.27829614604462477,0.3991886409736308,0.3225152129817444,5
051602,491,788,587,1866,051602,0.26312968917470525,0.42229367631296894,0.3145766345123258,5
051700,697,873,1812,3382,051700,0.2060910703725606,0.25813128326434065,0.5357776463630988,6
051701,363,525,629,1517,051701,0.23928806855636123,0.34607778510217535,0.4146341463414634,5
051702,345,576,613,1534,051702,0.22490221642764016,0.3754889178617992,0.39960886571056065,5
051800,1589,2286,2659,6534,051800,0.24318947046219774,0.349862258953168,0.40694827058463423,5
051900,871,1034,2607,4512,051900,0.19304078014184398,0.22916666666666666,0.5777925531914894,6
051901,405,552,1046,2003,051901,0.20219670494258613,0.27558662006989515,0.5222166749875187,6
051902,394,600,932,1926,051902,0.20456905503634476,0.3115264797507788,0.48390446521287644,5
052000,1127,1499,1925,4551,052000,0.24763788178422325,0.3293781586464513,0.42298395956932544,5
052002,178,238,559,975,052002,0.18256410256410258,0.2441025641025641,0.5733333333333334,6
052003,532,648,1316,2496,052003,0.21314102564102563,0.25961538461538464,0.5272435897435898,6
052004,649,922,1785,3356,052004,0.1933849821215733,0.27473182359952325,0.5318831942789034,6
052100,663,950,1449,3062,052100,0.21652514696276942,0.31025473546701504,0.47322011757021554,5
052101,211,251,498,960,052101,0.21979166666666666,0.26145833333333335,0.51875,6
052102,151,254,311,716,052102,0.21089385474860337,0.3547486033519553,0.43435754189944137,5
052103,169,253,357,779,052103,0.21694480102695765,0.3247753530166881,0.4582798459563543,5
052200,448,553,683,1684,052200,0.2660332541567696,0.32838479809976245,0.40558194774346795,5
052201,465,585,1170,2220,052201,0.20945945945945946,0.2635135135135135,0.527027027027027,6
052203,582,691,1398,2671,052203,0.21789591913141146,0.2587046050168476,0.523399475851741,6
052204,278,338,679,1295,052204,0.21467181467181468,0.261003861003861,0.5243243243243243,6
052300,541,801,1301,2643,052300,0.20469163828982218,0.3030646992054484,0.49224366250472945,5
052301,380,418,1007,1805,052301,0.21052631578947367,0.23157894736842105,0.5578947368421052,6
052303,153,178,356,687,052303,0.22270742358078602,0.2590975254730713,0.5181950509461426,6
052304,783,904,1830,3517,052304,0.22263292578902474,0.2570372476542508,0.5203298265567244,6
052400,169,301,318,788,052400,0.21446700507614214,0.3819796954314721,0.4035532994923858,5
052402,270,249,657,1176,052402,0.22959183673469388,0.21173469387755103,0.5586734693877551,6
052403,773,945,1976,3694,052403,0.20925825663237682,0.2558202490525176,0.5349214943151056,6
052404,894,990,2083,3967,052404,0.22535921351146962,0.24955886059994958,0.5250819258885808,6
052500,680,731,995,2406,052500,0.2826267664172901,0.3038237738985869,0.41354945968412304,5
052501,695,760,1719,3174,052501,0.2189666036546944,0.23944549464398235,0.5415879017013232,6
052502,518,678,1210,2406,052502,0.21529509559434745,0.2817955112219451,0.5029093931837074,6
052503,182,201,349,732,052503,0.24863387978142076,0.27459016393442626,0.476775956284153,6
052600,648,919,1233,2800,052600,0.23142857142857143,0.32821428571428574,0.44035714285714284,5
052601,382,481,876,1739,052601,0.21966647498562392,0.2765957446808511,0.503737780333525,6
052602,150,196,243,589,052602,0.2546689303904924,0.33276740237691,0.41256366723259763,5
052603,301,393,598,1292,052603,0.23297213622291021,0.3041795665634675,0.4628482972136223,5
052700,665,1017,1264,2946,052700,0.2257298031228785,0.34521384928716903,0.4290563475899525,5
052800,350,482,710,1542,052800,0.22697795071335927,0.3125810635538262,0.4604409857328145,5
052900,526,327,384,1237,052900,0.42522231204527083,0.26434923201293453,0.3104284559417947,2
053000,591,928,978,2497,053000,0.23668402082499,0.37164597517020426,0.3916700040048058,5
053100,1640,1252,1227,4119,053100,0.39815489196406895,0.3039572711823258,0.29788783685360526,1
053200,465,678,871,2014,053200,0.23088381330685204,0.33664349553128103,0.43247269116186693,5
053300,774,483,385,1642,053300,0.4713763702801462,0.29415347137637027,0.23447015834348356,0
053400,520,682,587,1789,053400,0.2906651760760201,0.38121855785354947,0.32811626607043043,5
053401,198,377,386,961,053401,0.2060353798126951,0.3922996878251821,0.4016649323621228,5
053500,762,575,590,1927,053500,0.39543331603528803,0.2983912817851583,0.3061754021795537,2
053601,187,307,322,816,053601,0.22916666666666666,0.3762254901960784,0.3946078431372549,5
053700,420,275,215,910,053700,0.46153846153846156,0.3021978021978022,0.23626373626373626,1
053800,731,1171,1222,3124,053800,0.23399487836107555,0.37483994878361077,0.3911651728553137,5
053900,751,952,1272,2975,053900,0.25243697478991595,0.32,0.42756302521008405,5
054000,467,750,770,1987,054000,0.2350276799194766,0.377453447408153,0.3875188726723704,5
054200,994,1390,1778,4162,054200,0.2388274867851994,0.3339740509370495,0.4271984622777511,5
054300,84,98,230,412,054300,0.20388349514563106,0.23786407766990292,0.558252427184466,6
054400,422,478,652,1552,054400,0.27190721649484534,0.3079896907216495,0.42010309278350516,5
054500,1170,1212,1139,3521,054500,0.3322919625106504,0.34422039193410964,0.32348764555524,3
054600,593,688,803,2084,054600,0.2845489443378119,0.33013435700575816,0.3853166986564299,5
054700,1046,1209,1478,3733,054700,0.28020358960621483,0.32386820251808196,0.3959282078757032,5
054800,462,603,933,1998,054800,0.23123123123123124,0.30180180180180183,0.466966966966967,5
054900,881,1250,1854,3985,054900,0.22107904642409035,0.3136762860727729,0.46524466750313676,5
055000,354,501,644,1499,055000,0.2361574382921948,0.3342228152101401,0.4296197464976651,5
055100,921,1425,2201,4547,055100,0.20255113261491092,0.31339344622828236,0.48405542115680666,5
055200,679,1007,1196,2882,055200,0.2356002775850104,0.34941013185287995,0.41498959056210966,5
055300,592,808,1580,2980,055300,0.19865771812080538,0.27114093959731544,0.5302013422818792,6
055400,735,1001,1167,2903,055400,0.2531863589390286,0.34481570788839133,0.4019979331725801,5
055500,557,777,2406,3740,055500,0.14893048128342246,0.20775401069518717,0.6433155080213904,6
055600,580,878,1142,2600,055600,0.2230769230769231,0.3376923076923077,0.43923076923076926,5
055700,574,871,1605,3050,055700,0.1881967213114754,0.28557377049180327,0.5262295081967213,6
055800,458,628,812,1898,055800,0.24130663856691253,0.3308746048472076,0.42781875658587987,5
055900,142,261,251,654,055900,0.21712538226299694,0.39908256880733944,0.3837920489296636,5
056000,542,803,1035,2380,056000,0.22773109243697479,0.3373949579831933,0.43487394957983194,5
056100,397,495,1380,2272,056100,0.17473591549295775,0.21786971830985916,0.6073943661971831,6
056200,326,431,678,1435,056200,0.22717770034843204,0.3003484320557491,0.47247386759581883,5
056300,399,507,1348,2254,056300,0.17701863354037267,0.22493345164152617,0.5980479148181012,6
056400,429,605,839,1873,056400,0.22904431393486385,0.3230112119594234,0.44794447410571275,5
056500,503,696,1560,2759,056500,0.1823124320405944,0.2522653135193911,0.5654222544400145,6
056600,421,584,896,1901,056600,0.22146238821672803,0.3072067332982641,0.4713308784850079,5
056700,392,642,1085,2119,056700,0.1849929211892402,0.3029731005191128,0.512033978291647,5
056800,622,970,1160,2752,056800,0.22601744186046513,0.35247093023255816,0.42151162790697677,5
056900,177,214,705,1096,056900,0.16149635036496351,0.19525547445255476,0.6432481751824818,6
057000,277,374,630,1281,057000,0.21623731459797033,0.29195940671350507,0.4918032786885246,6
057100,419,547,1428,2394,057100,0.17502088554720133,0.2284878863826232,0.5964912280701754,6
057200,665,915,749,2329,057200,0.2855302705023615,0.3928724774581365,0.32159725203950196,5
057300,294,358,920,1572,057300,0.18702290076335878,0.227735368956743,0.5852417302798982,6
057400,245,352,428,1025,057400,0.23902439024390243,0.3434146341463415,0.4175609756097561,5
057500,411,579,1365,2355,057500,0.17452229299363056,0.24585987261146497,0.5796178343949044,6
057600,319,405,508,1232,057600,0.25892857142857145,0.3287337662337662,0.41233766233766234,5
057700,325,519,816,1660,057700,0.19578313253012047,0.31265060240963854,0.491566265060241,5
057800,347,409,466,1222,057800,0.2839607201309329,0.33469721767594107,0.381342062193126,5
057900,316,497,774,1587,057900,0.19911783238815375,0.313169502205419,0.4877126654064272,5
058000,667,1049,1277,2993,058000,0.22285332442365519,0.3504844637487471,0.4266622118275977,5
058100,268,443,686,1397,058100,0.19183965640658554,0.31710808876163205,0.4910522548317824,5
058200,671,1071,1169,2911,058200,0.2305049811061491,0.36791480590862247,0.40158021298522845,5
058300,312,532,791,1635,058300,0.1908256880733945,0.3253822629969419,0.4837920489296636,5
058400,383,411,615,1409,058400,0.2718239886444287,0.2916962384669979,0.4364797728885735,6
058500,366,678,906,1950,058500,0.18769230769230769,0.3476923076923077,0.4646153846153846,5
058600,290,311,371,972,058600,0.29835390946502055,0.31995884773662553,0.3816872427983539,5
058700,267,552,746,1565,058700,0.1706070287539936,0.3527156549520767,0.47667731629392973,5
058800,290,448,642,1380,058800,0.21014492753623187,0.32463768115942027,0.4652173913043478,5
058900,597,854,1416,2867,058900,0.20823160097663063,0.2978723404255319,0.4938960585978375,6
059000,296,462,580,1338,059000,0.22122571001494767,0.3452914798206278,0.4334828101644245,5
059100,885,1308,2252,4445,059100,0.19910011248593926,0.2942632170978628,0.506636670416198,6
059200,558,740,979,2277,059200,0.2450592885375494,0.32498902064119456,0.42995169082125606,5
059300,600,989,1624,3213,059300,0.18674136321195145,0.3078120136943666,0.5054466230936819,5
059400,161,242,378,781,059400,0.20614596670934698,0.30985915492957744,0.4839948783610755,5
059401,684,977,1192,2853,059401,0.23974763406940064,0.3424465474938661,0.41780581843673326,5
059402,369,514,859,1742,059402,0.21182548794489092,0.29506314580941445,0.4931113662456946,6
059500,391,739,1000,2130,059500,0.1835680751173709,0.34694835680751174,0.4694835680751174,5
059600,369,585,772,1726,059600,0.2137891077636153,0.3389339513325608,0.44727694090382386,5
059800,411,741,921,2073,059800,0.19826338639652677,0.35745296671490595,0.4442836468885673,5
059900,164,268,486,918,059900,0.1786492374727669,0.29193899782135074,0.5294117647058824,6
060000,695,1020,1371,3086,060000,0.2252106286454958,0.3305249513933895,0.4442644199611147,5
060100,993,1375,2117,4485,060100,0.2214046822742475,0.30657748049052397,0.47201783723522855,5
060101,765,1011,1424,3200,060101,0.2390625,0.3159375,0.445,5
060102,734,944,1354,3032,060102,0.2420844327176781,0.3113456464379947,0.4465699208443272,5
060200,1144,1505,1519,4168,060200,0.2744721689059501,0.361084452975048,0.3644433781190019,5
060201,385,429,888,1702,060201,0.22620446533490013,0.2520564042303173,0.5217391304347826,6
060202,428,516,865,1809,060202,0.23659480375898287,0.28524046434494194,0.47816473189607517,6
060300,915,1333,1796,4044,060300,0.22626112759643918,0.32962413452027695,0.44411473788328387,5
060301,474,488,1045,2007,060301,0.23617339312406577,0.24314897857498755,0.5206776283009467,6
060302,240,219,569,1028,060302,0.23346303501945526,0.2130350194552529,0.5535019455252919,6
060400,1183,1452,1918,4553,060400,0.2598286843839227,0.31891060839007246,0.42126070722600484,5
060500,426,632,668,1726,060500,0.24681344148319814,0.36616454229432216,0.3870220162224797,5
060501,242,322,373,937,060501,0.25827107790821774,0.343649946638207,0.39807897545357523,5
060502,213,328,333,874,060502,0.2437070938215103,0.37528604118993136,0.38100686498855835,5
060503,278,340,498,1116,060503,0.24910394265232974,0.3046594982078853,0.44623655913978494,5
060600,891,1283,1378,3552,060600,0.25084459459459457,0.36120495495495497,0.38795045045045046,5
060601,309,374,641,1324,060601,0.23338368580060423,0.2824773413897281,0.48413897280966767,6
060602,601,710,1134,2445,060602,0.2458077709611452,0.2903885480572597,0.4638036809815951,6
060700,427,560,501,1488,060700,0.28696236559139787,0.3763440860215054,0.33669354838709675,5
060701,919,1146,1713,3778,060701,0.2432503970354685,0.3033350979354156,0.45341450502911596,5
060702,1030,986,2246,4262,060702,0.24167057719380572,0.2313467855466917,0.5269826372595026,6
060800,1163,1477,2272,4912,060800,0.2367671009771987,0.30069218241042345,0.46254071661237783,5
060803,248,186,158,592,060803,0.4189189189189189,0.3141891891891892,0.2668918918918919,1
060804,276,259,223,758,060804,0.3641160949868074,0.341688654353562,0.2941952506596306,1
060900,529,721,582,1832,060900,0.28875545851528384,0.3935589519650655,0.31768558951965065,5
060901,454,570,936,1960,060901,0.2316326530612245,0.29081632653061223,0.4775510204081633,6
060902,272,378,331,981,060902,0.27726809378185524,0.3853211009174312,0.33741080530071355,5
061000,953,1192,1845,3990,061000,0.23884711779448622,0.2987468671679198,0.462406015037594,6
061002,378,559,824,1761,061002,0.21465076660988075,0.31743327654741627,0.467915956842703,5
061003,191,245,236,672,061003,0.28422619047619047,0.3645833333333333,0.35119047619047616,5
061004,649,891,879,2419,061004,0.2682926829268293,0.36833402232327406,0.36337329474989666,5
061100,1114,1184,1910,4208,061100,0.2647338403041825,0.2813688212927757,0.4538973384030418,6
061200,1266,1475,2105,4846,061200,0.2612463887742468,0.30437474205530335,0.4343788691704499,5
061300,302,437,302,1041,061300,0.29010566762728146,0.4197886647454371,0.29010566762728146,4
061301,891,1096,2102,4089,061301,0.21790168745414526,0.26803619466862316,0.5140621178772316,6
061302,781,868,1636,3285,061302,0.23774733637747336,0.26423135464231357,0.4980213089802131,6
061303,147,56,121,324,061303,0.4537037037037037,0.1728395061728395,0.3734567901234568,2
061400,513,770,602,1885,061400,0.27214854111405834,0.40848806366047746,0.3193633952254642,5
061401,627,878,929,2434,061401,0.25760065735414955,0.3607230895645029,0.38167625308134756,5
061403,749,840,1461,3050,061403,0.2455737704918033,0.2754098360655738,0.4790163934426229,6
061404,392,406,919,1717,061404,0.22830518345952241,0.23645894001164822,0.5352358765288293,6
061500,797,1042,1377,3216,061500,0.2478233830845771,0.3240049751243781,0.4281716417910448,5
061600,987,1300,2045,4332,061600,0.2278393351800554,0.30009233610341646,0.47206832871652815,5
061601,252,376,500,1128,061601,0.22340425531914893,0.3333333333333333,0.4432624113475177,5
061602,142,235,316,693,061602,0.2049062049062049,0.33910533910533913,0.455988455988456,5
061700,198,310,285,793,061700,0.24968474148802017,0.39092055485498106,0.3593947036569987,5
061701,479,566,1253,2298,061701,0.20844212358572672,0.2463011314186249,0.5452567449956484,6
061702,486,574,1213,2273,061702,0.21381434227892654,0.25252969643642764,0.5336559612846459,6
061800,1574,2083,2762,6419,061800,0.24520953419535754,0.3245053746689516,0.4302850911356909,5
061900,639,817,1356,2812,061900,0.22724039829302986,0.2905405405405405,0.4822190611664296,6
061901,901,972,2651,4524,061901,0.19916003536693191,0.21485411140583555,0.5859858532272325,6
061903,629,770,1589,2988,061903,0.2105087014725569,0.2576974564926372,0.5317938420348058,6
062000,1099,1376,2502,4977,062000,0.22081575246132207,0.2764717701426562,0.5027124773960217,6
062100,988,1276,1348,3612,062100,0.27353266888150607,0.3532668881506091,0.37320044296788485,5
062200,1236,1687,2262,5185,062200,0.23837994214079075,0.32536162005785924,0.43625843780135004,5
062300,413,559,915,1887,062300,0.21886592474827768,0.2962374138844727,0.4848966613672496,6
062400,452,625,735,1812,062400,0.24944812362030905,0.34492273730684325,0.4056291390728477,5
062403,710,893,1862,3465,062403,0.2049062049062049,0.25772005772005774,0.5373737373737374,6
062404,228,270,570,1068,062404,0.21348314606741572,0.25280898876404495,0.5337078651685393,6
062405,686,857,1639,3182,062405,0.21558768070395978,0.2693274670018856,0.5150848522941546,6
062406,381,486,900,1767,062406,0.21561969439728354,0.27504244482173174,0.5093378607809848,6
062500,515,774,1087,2376,062500,0.21675084175084175,0.32575757575757575,0.4574915824915825,5
062501,564,518,1554,2636,062501,0.21396054628224584,0.19650986342943855,0.5895295902883156,6
062503,616,669,1710,2995,062503,0.20567612687813022,0.22337228714524207,0.5709515859766278,6
062505,429,337,1110,1876,062505,0.2286780383795309,0.17963752665245203,0.591684434968017,6
062506,530,598,1829,2957,062506,0.17923571187013865,0.2022319918836659,0.6185322962461954,6
062507,377,455,1126,1958,062507,0.19254341164453523,0.2323799795709908,0.575076608784474,6
062508,454,523,1280,2257,062508,0.20115197164377493,0.23172352680549402,0.567124501550731,6
062509,369,366,926,1661,062509,0.22215532811559302,0.22034918723660446,0.5574954846478025,6
062600,458,767,1055,2280,062600,0.20087719298245615,0.3364035087719298,0.46271929824561403,5
062601,281,321,780,1382,062601,0.20332850940665703,0.23227206946454415,0.5643994211287988,6
062602,615,680,1880,3175,062602,0.19370078740157481,0.2141732283464567,0.5921259842519685,6
062700,1020,1316,2329,4665,062700,0.21864951768488747,0.28210075026795284,0.4992497320471597,6
062800,690,884,1468,3042,062800,0.22682445759368836,0.2905982905982906,0.482577251808021,6
062900,261,441,709,1411,062900,0.184975194897236,0.31254429482636426,0.5024805102763997,5
063000,160,268,371,799,063000,0.2002503128911139,0.3354192740926158,0.4643304130162703,5
063200,351,561,779,1691,063200,0.20756948551153165,0.33175635718509755,0.4606741573033708,5
063301,157,237,404,798,063301,0.19674185463659147,0.29699248120300753,0.506265664160401,6
063302,134,223,465,822,063302,0.1630170316301703,0.2712895377128954,0.5656934306569343,6
063500,219,328,669,1216,063500,0.18009868421052633,0.26973684210526316,0.5501644736842105,6
063600,161,200,396,757,063600,0.21268163804491413,0.26420079260237783,0.523117569352708,6
063700,262,368,949,1579,063700,0.16592780240658644,0.2330588980367321,0.6010132995566815,6
063800,474,697,1065,2236,063800,0.21198568872987478,0.31171735241502685,0.4762969588550984,5
063900,225,372,808,1405,063900,0.1601423487544484,0.26476868327402137,0.5750889679715302,6
064000,188,196,449,833,064000,0.22569027611044418,0.23529411764705882,0.539015606242497,6
064101,198,324,571,1093,064101,0.18115279048490393,0.29643183897529735,0.5224153705397987,6
064102,30,63,86,179,064102,0.16759776536312848,0.35195530726256985,0.48044692737430167,5
064200,262,334,456,1052,064200,0.24904942965779467,0.31749049429657794,0.43346007604562736,5
064400,225,296,552,1073,064400,0.2096924510717614,0.27586206896551724,0.5144454799627214,6
064500,163,251,574,988,064500,0.16497975708502025,0.2540485829959514,0.5809716599190283,6
064600,478,741,1141,2360,064600,0.20254237288135593,0.31398305084745765,0.48347457627118645,5
064800,217,313,469,999,064800,0.2172172172172172,0.3133133133133133,0.4694694694694695,5
065000,382,660,1003,2045,065000,0.18679706601466992,0.32273838630806845,0.4904645476772616,5
065200,135,170,380,685,065200,0.19708029197080293,0.24817518248175183,0.5547445255474452,6
065400,469,697,1108,2274,065400,0.20624450307827616,0.3065083553210202,0.4872471416007036,5
065501,50,55,75,180,065501,0.2777777777777778,0.3055555555555556,0.4166666666666667,5
065600,605,991,1438,3034,065600,0.1994067237969677,0.3266315095583388,0.47396176664469347,5
065702,174,252,501,927,065702,0.18770226537216828,0.27184466019417475,0.540453074433657,6
065703,234,312,806,1352,065703,0.17307692307692307,0.23076923076923078,0.5961538461538461,6
065800,159,240,485,884,065800,0.17986425339366516,0.27149321266968324,0.5486425339366516,6
065900,135,254,524,913,065900,0.14786418400876233,0.2782037239868565,0.5739320920043811,6
066000,535,748,1153,2436,066000,0.21962233169129722,0.3070607553366174,0.4733169129720854,5
066100,114,182,498,794,066100,0.14357682619647355,0.22921914357682618,0.6272040302267002,6
066200,175,246,349,770,066200,0.22727272727272727,0.3194805194805195,0.45324675324675323,5
066300,225,326,756,1307,066300,0.17214996174445293,0.24942616679418517,0.5784238714613619,6
066400,795,1356,1723,3874,066400,0.2052142488384099,0.3500258131130614,0.44475993804852865,5
066501,252,359,860,1471,066501,0.17131203263086336,0.24405166553365057,0.5846363018354861,6
066600,60,55,63,178,066600,0.33707865168539325,0.3089887640449438,0.3539325842696629,3
066701,212,342,681,1235,066701,0.17165991902834007,0.27692307692307694,0.551417004048583,6
066900,166,219,516,901,066900,0.18423973362930077,0.24306326304106549,0.5726970033296337,6
067000,233,380,567,1180,067000,0.19745762711864406,0.3220338983050847,0.48050847457627116,5
067100,184,287,679,1150,067100,0.16,0.24956521739130436,0.5904347826086956,6
067200,164,213,324,701,067200,0.23395149786019973,0.30385164051355207,0.46219686162624823,5
067400,232,314,521,1067,067400,0.21743205248359887,0.2942830365510778,0.48828491096532334,6
067600,204,266,383,853,067600,0.2391559202813599,0.3118405627198124,0.4490035169988277,5
067700,180,250,621,1051,067700,0.17126546146527116,0.23786869647954328,0.5908658420551856,6
067800,239,398,484,1121,067800,0.21320249776984834,0.35504014272970563,0.431757359500446,5
067900,436,576,902,1914,067900,0.2277951933124347,0.30094043887147337,0.47126436781609193,5
068000,604,986,1384,2974,068000,0.203093476798924,0.33154001344989914,0.4653665097511769,5
068200,410,589,791,1790,068200,0.22905027932960895,0.32905027932960895,0.44189944134078213,5
068300,399,571,912,1882,068300,0.21200850159404888,0.30340063761955366,0.48459086078639746,5
068600,160,208,344,712,068600,0.2247191011235955,0.29213483146067415,0.48314606741573035,6
068700,427,665,1147,2239,068700,0.19071013845466725,0.29700759267530147,0.5122822688700313,6
068800,184,236,460,880,068800,0.20909090909090908,0.2681818181818182,0.5227272727272727,6
069000,479,785,1088,2352,069000,0.203656462585034,0.33375850340136054,0.46258503401360546,5
069200,217,331,513,1061,069200,0.20452403393025448,0.31196983977379833,0.48350612629594725,5
069300,294,396,841,1531,069300,0.19203135205747876,0.25865447419986937,0.5493141737426519,6
069400,300,504,543,1347,069400,0.22271714922049,0.3741648106904232,0.40311804008908686,5
069500,226,310,565,1101,069500,0.2052679382379655,0.2815622161671208,0.5131698455949137,6
069601,330,411,653,1394,069601,0.23672883787661406,0.29483500717360117,0.4684361549497848,6
069602,503,670,1397,2570,069602,0.19571984435797665,0.2607003891050584,0.5435797665369649,6
069701,330,438,1031,1799,069701,0.18343524180100054,0.2434685936631462,0.5730961645358532,6
069702,315,403,924,1642,069702,0.19183922046285018,0.24543239951278928,0.5627283800243605,6
069800,142,217,374,733,069800,0.1937244201909959,0.296043656207367,0.5102319236016372,6
070000,168,274,444,886,070000,0.18961625282167044,0.309255079006772,0.5011286681715575,5
070100,332,545,573,1450,070100,0.2289655172413793,0.3758620689655172,0.39517241379310347,5
070101,526,578,965,2069,070101,0.2542290961817303,0.27936201063315613,0.4664088931851136,6
070102,372,529,855,1756,070102,0.21184510250569477,0.30125284738041,0.4869020501138952,5
070200,490,700,515,1705,070200,0.2873900293255132,0.41055718475073316,0.3020527859237537,5
070201,862,1134,2013,4009,070201,0.21501621351958095,0.2828635569967573,0.5021202294836618,6
070202,46,76,73,195,070202,0.2358974358974359,0.38974358974358975,0.37435897435897436,5
070203,41,51,61,153,070203,0.2679738562091503,0.3333333333333333,0.39869281045751637,5
070300,964,1241,1463,3668,070300,0.2628135223555071,0.3383315158124318,0.3988549618320611,5
070301,674,889,1558,3121,070301,0.21595642422300546,0.2848446010893944,0.4991989746876001,6
070400,728,1007,911,2646,070400,0.2751322751322751,0.3805744520030234,0.34429327286470146,5
070401,393,492,868,1753,070401,0.22418710781517398,0.28066172276098117,0.49515116942384485,6
070500,688,834,776,2298,070500,0.299390774586597,0.3629242819843342,0.33768494342906874,5
070600,463,629,876,1968,070600,0.23526422764227642,0.3196138211382114,0.4451219512195122,5
070601,717,744,1095,2556,070601,0.2805164319248826,0.29107981220657275,0.4284037558685446,6
070602,168,169,323,660,070602,0.2545454545454545,0.25606060606060604,0.4893939393939394,6
070700,482,679,1153,2314,070700,0.20829732065687123,0.2934312878133103,0.4982713915298185,6
070701,418,454,645,1517,070701,0.27554383651944625,0.2992748846407383,0.42518127883981544,6
070702,590,609,958,2157,070702,0.27352804821511356,0.282336578581363,0.4441353732035234,6
070800,1234,1725,1788,4747,070800,0.2599536549399621,0.36338740257004426,0.37665894248999365,5
070900,931,1107,1945,3983,070900,0.23374340949033393,0.27793120763243784,0.4883253828772282,6
071000,392,570,556,1518,071000,0.25823451910408435,0.37549407114624506,0.3662714097496706,5
071100,377,534,1841,2752,071100,0.13699127906976744,0.19404069767441862,0.668968023255814,6
071303,393,497,1779,2669,071303,0.14724615961034096,0.18621206444361185,0.6665417759460472,6
071304,475,685,1579,2739,071304,0.17342095655348666,0.25009127418765975,0.5764877692588536,6
071305,358,468,1605,2431,071305,0.14726450020567666,0.1925133689839572,0.6602221308103661,6
071306,529,680,1889,3098,071306,0.17075532601678503,0.21949644932214332,0.6097482246610717,6
071600,37,42,59,138,071600,0.26811594202898553,0.30434782608695654,0.427536231884058,5
071701,460,652,1504,2616,071701,0.17584097859327216,0.2492354740061162,0.5749235474006116,6
071702,405,567,1186,2158,071702,0.1876737720111214,0.26274328081556997,0.5495829471733086,6
071900,276,394,577,1247,071900,0.22133119486768243,0.31595829991980756,0.46271050521251,5
072000,645,820,929,2394,072000,0.2694235588972431,0.34252297410192145,0.38805346700083543,5
072100,1081,1447,2355,4883,072100,0.22138029899651854,0.2963342207659226,0.48228548023755885,6
072200,589,1049,1123,2761,072200,0.21332850416515756,0.37993480622962694,0.40673668960521553,5
072300,394,629,1011,2034,072300,0.19370698131760078,0.30924287118977384,0.4970501474926254,5
072400,441,730,740,1911,072400,0.23076923076923078,0.3819989534275249,0.3872318158032444,5
072500,416,625,493,1534,072500,0.2711864406779661,0.4074315514993481,0.3213820078226858,5
072600,607,950,997,2554,072600,0.23766640563821456,0.37196554424432265,0.3903680501174628,5
072700,413,645,671,1729,072700,0.2388663967611336,0.373048004626952,0.3880855986119144,5
072800,741,1109,1499,3349,072800,0.22126007763511496,0.3311436249626754,0.44759629740220963,5
072900,128,175,425,728,072900,0.17582417582417584,0.2403846153846154,0.5837912087912088,6
073000,687,1083,1014,2784,073000,0.24676724137931033,0.3890086206896552,0.3642241379310345,5
073100,158,198,437,793,073100,0.19924337957124844,0.24968474148802017,0.5510718789407314,6
073200,243,350,476,1069,073200,0.2273152478952292,0.3274087932647334,0.4452759588400374,5
073400,222,365,410,997,073400,0.2226680040120361,0.36609829488465395,0.4112337011033099,5
073500,255,321,278,854,073500,0.29859484777517564,0.3758782201405152,0.3255269320843091,5
073600,336,554,616,1506,073600,0.22310756972111553,0.36786188579017265,0.40903054448871184,5
073700,185,255,763,1203,073700,0.15378221113881962,0.2119700748129676,0.6342477140482128,6
073800,364,589,650,1603,073800,0.22707423580786026,0.36743605739238927,0.4054897067997505,5
073900,322,476,1752,2550,073900,0.12627450980392158,0.18666666666666668,0.6870588235294117,6
074000,650,876,867,2393,074000,0.27162557459256165,0.36606769745089845,0.3623067279565399,5
074100,234,275,1058,1567,074100,0.14932992980216975,0.17549457562220805,0.6751754945756222,6
074200,352,523,628,1503,074200,0.23419827012641384,0.3479707252162342,0.41783100465735196,5
074300,394,481,1014,1889,074300,0.20857596611964002,0.25463208046585495,0.536791953414505,6
074400,245,337,506,1088,074400,0.22518382352941177,0.30974264705882354,0.4650735294117647,5
074500,370,485,759,1614,074500,0.22924411400247832,0.30049566294919455,0.47026022304832715,5
074600,170,305,426,901,074600,0.18867924528301888,0.33851276359600446,0.4728079911209767,5
074700,287,401,846,1534,074700,0.18709256844850064,0.26140808344198174,0.5514993481095176,6
074800,199,269,434,902,074800,0.22062084257206208,0.2982261640798226,0.4811529933481153,6
074900,116,169,481,766,074900,0.1514360313315927,0.2206266318537859,0.6279373368146214,6
075000,655,899,981,2535,075000,0.2583826429980276,0.35463510848126234,0.38698224852071006,5
075200,132,150,276,558,075200,0.23655913978494625,0.26881720430107525,0.4946236559139785,6
075400,168,232,292,692,075400,0.24277456647398843,0.3352601156069364,0.42196531791907516,5
075600,235,272,439,946,075600,0.24841437632135308,0.28752642706131076,0.46405919661733613,6
075701,326,458,1748,2532,075701,0.1287519747235387,0.18088467614533965,0.6903633491311216,6
075702,329,388,1437,2154,075702,0.15273909006499536,0.18012999071494892,0.6671309192200557,6
075800,200,295,340,835,075800,0.23952095808383234,0.3532934131736527,0.40718562874251496,5
076000,600,804,796,2200,076000,0.2727272727272727,0.3654545454545455,0.3618181818181818,5
076200,513,668,685,1866,076200,0.27491961414790994,0.3579849946409432,0.3670953912111468,5
076400,402,704,693,1799,076400,0.22345747637576432,0.3913285158421345,0.3852140077821012,5
076600,255,442,427,1124,076600,0.22686832740213522,0.3932384341637011,0.3798932384341637,5
076800,399,452,529,1380,076800,0.2891304347826087,0.32753623188405795,0.38333333333333336,5
076901,278,378,1620,2276,076901,0.12214411247803164,0.16608084358523725,0.7117750439367311,6
076902,142,195,588,925,076902,0.1535135135135135,0.21081081081081082,0.6356756756756756,6
077000,326,536,514,1376,077000,0.2369186046511628,0.38953488372093026,0.373546511627907,5
077200,332,524,591,1447,077200,0.2294402211472011,0.3621285418106427,0.40843123704215617,5
077300,234,288,713,1235,077300,0.18947368421052632,0.23319838056680162,0.5773279352226721,6
077400,332,556,569,1457,077400,0.22786547700754975,0.3816060398078243,0.39052848318462596,5
077500,205,282,614,1101,077500,0.18619436875567666,0.2561307901907357,0.5576748410535877,6
077600,347,710,871,1928,077600,0.1799792531120332,0.3682572614107884,0.45176348547717843,5
077902,397,510,1079,1986,077902,0.1998992950654582,0.256797583081571,0.5433031218529708,6
077903,316,452,713,1481,077903,0.21336934503713706,0.30519918973666443,0.4814314652261985,5
077904,542,741,1114,2397,077904,0.2261159783062161,0.3091364205256571,0.4647476011681268,5
077905,206,270,572,1048,077905,0.1965648854961832,0.25763358778625955,0.5458015267175572,6
077906,340,378,681,1399,077906,0.24303073624017155,0.270192994996426,0.4867762687634024,6
077907,296,346,567,1209,077907,0.24483043837882548,0.28618693134822165,0.46898263027295284,6
077908,372,460,685,1517,077908,0.24522083058668426,0.3032300593276203,0.4515491100856954,5
078000,496,758,783,2037,078000,0.24349533627884143,0.37211585665193914,0.38438880706921946,5
078200,497,853,644,1994,078200,0.24924774322968907,0.42778335005015045,0.3229689067201605,5
078400,283,447,473,1203,078400,0.23524522028262676,0.371571072319202,0.3931837073981712,5
078600,466,799,700,1965,078600,0.23715012722646311,0.40661577608142496,0.356234096692112,5
078800,543,1030,808,2381,078800,0.22805543889122218,0.4325913481730365,0.3393532129357413,5
079000,812,1412,1095,3319,079000,0.24465200361554684,0.425429346188611,0.3299186501958421,5
079200,669,1151,873,2693,079200,0.24842183438544374,0.4274043817304122,0.3241737838841441,5
079300,41,35,46,122,079300,0.3360655737704918,0.28688524590163933,0.3770491803278688,2
079400,222,375,351,948,079400,0.23417721518987342,0.39556962025316456,0.370253164556962,5
079601,451,775,998,2224,079601,0.20278776978417265,0.34847122302158273,0.4487410071942446,5
079602,535,860,796,2191,079602,0.24418073938840712,0.3925148334094021,0.3633044272021908,5
079701,752,760,1121,2633,079701,0.2856057728826434,0.28864413216862894,0.4257500949487277,6
079702,620,633,504,1757,079702,0.3528742174160501,0.36027319294251564,0.2868525896414343,1
079801,389,495,853,1737,079801,0.22394933793897526,0.2849740932642487,0.491076568796776,6
079802,627,1074,1216,2917,079802,0.2149468632156325,0.36818649297223177,0.41686664381213573,5
079900,440,467,425,1332,079900,0.3303303303303303,0.3506006006006006,0.31906906906906907,3
080000,369,548,732,1649,080000,0.22377198302001214,0.3323226197695573,0.44390539721043054,5
080100,963,1397,1305,3665,080100,0.2627557980900409,0.3811732605729877,0.35607094133697137,5
080103,492,516,1038,2046,080103,0.2404692082111437,0.25219941348973607,0.5073313782991202,6
080104,387,380,818,1585,080104,0.24416403785488958,0.23974763406940064,0.5160883280757098,6
080200,711,1154,1294,3159,080200,0.22507122507122507,0.3653054764165875,0.40962329851218743,5
080201,937,1029,1804,3770,080201,0.24854111405835544,0.2729442970822281,0.47851458885941645,6
080202,596,603,1093,2292,080202,0.2600349040139616,0.2630890052356021,0.4768760907504363,6
080300,1039,1247,1457,3743,080300,0.27758482500667914,0.3331552230830884,0.38925995191023244,5
080301,538,606,550,1694,080301,0.31759149940968123,0.3577331759149941,0.3246753246753247,3
080302,443,539,595,1577,080302,0.2809131261889664,0.3417882054533925,0.3772986683576411,5
080400,329,479,509,1317,080400,0.2498101746393318,0.36370539104024296,0.38648443432042523,5
080401,280,227,237,744,080401,0.3763440860215054,0.30510752688172044,0.3185483870967742,3
080402,188,224,233,645,080402,0.29147286821705426,0.34728682170542635,0.3612403100775194,5
080501,283,426,483,1192,080501,0.23741610738255034,0.3573825503355705,0.4052013422818792,5
080502,438,530,598,1566,080502,0.2796934865900383,0.3384418901660281,0.3818646232439336,5
080600,686,852,1137,2675,080600,0.25644859813084114,0.31850467289719625,0.4250467289719626,5
080700,377,432,613,1422,080700,0.2651195499296765,0.3037974683544304,0.4310829817158931,5
080800,200,258,260,718,080800,0.2785515320334262,0.3593314763231198,0.362116991643454,5
080900,936,1172,2097,4205,080900,0.2225921521997622,0.2787158145065398,0.498692033293698,6
081000,1188,1736,1835,4759,081000,0.24963227568816979,0.3647825173355747,0.38558520697625553,5
081101,408,564,717,1689,081101,0.24156305506216696,0.3339253996447602,0.42451154529307283,5
081102,291,439,538,1268,081102,0.22949526813880125,0.3462145110410095,0.4242902208201893,5
081400,551,1099,1060,2710,081400,0.2033210332103321,0.4055350553505535,0.39114391143911437,5
081600,295,519,463,1277,081600,0.23101018010963195,0.40642129992169146,0.36256851996867656,5
081800,873,1492,1484,3849,081800,0.22681215900233828,0.3876331514679137,0.385554689529748,5
082000,550,1010,759,2319,082000,0.23717119448037946,0.43553255713669686,0.32729624838292365,5
082001,533,863,787,2183,082001,0.24415941365093907,0.39532753092075124,0.3605130554283097,5
082002,120,182,208,510,082002,0.23529411764705882,0.3568627450980392,0.40784313725490196,5
082200,732,1359,1124,3215,082200,0.2276827371695179,0.42270606531881805,0.3496111975116641,5
082400,520,894,709,2123,082400,0.24493641073951955,0.42110221384832786,0.3339613754121526,5
082600,680,1067,824,2571,082600,0.26448852586542204,0.4150136133800078,0.3204978607545702,5
082800,496,761,564,1821,082800,0.2723778143876991,0.41790225151015925,0.30971993410214166,5
083000,757,1182,885,2824,083000,0.26805949008498586,0.4185552407932011,0.313385269121813,5
083200,211,419,435,1065,083200,0.19812206572769953,0.39342723004694835,0.4084507042253521,5
083400,187,294,342,823,083400,0.22721749696233293,0.3572296476306197,0.4155528554070474,5
083600,225,361,391,977,083600,0.23029682702149437,0.3694984646878199,0.4002047082906858,5
083700,659,694,714,2067,083700,0.31881954523463957,0.33575229801644896,0.3454281567489115,3
083800,615,1057,1383,3055,083800,0.20130932896890344,0.34599018003273324,0.45270049099836335,5
084000,1445,2449,2523,6417,084000,0.22518310737104566,0.38164251207729466,0.39317438055165965,5
084500,696,793,554,2043,084500,0.3406754772393539,0.38815467449828683,0.2711698482623593,1
084600,228,331,360,919,084600,0.24809575625680086,0.3601741022850925,0.39173014145810664,5
084601,215,408,601,1224,084601,0.17565359477124182,0.3333333333333333,0.4910130718954248,5
084602,122,161,259,542,084602,0.22509225092250923,0.29704797047970477,0.477859778597786,6
084800,190,275,349,814,084800,0.2334152334152334,0.33783783783783783,0.42874692874692877,5
084900,1040,962,611,2613,084900,0.39800995024875624,0.3681592039800995,0.23383084577114427,1
085000,476,678,779,1933,085000,0.24624935333678222,0.35075012933264355,0.40300051733057424,5
085200,43,51,69,163,085200,0.26380368098159507,0.3128834355828221,0.4233128834355828,5
085300,724,627,645,1996,085300,0.3627254509018036,0.31412825651302606,0.32314629258517036,3
085400,252,356,375,983,085400,0.25635808748728384,0.3621566632756867,0.3814852492370295,5
085500,898,960,946,2804,085500,0.3202567760342368,0.34236804564907275,0.33737517831669045,3
085600,444,691,665,1800,085600,0.24666666666666667,0.3838888888888889,0.36944444444444446,5
085700,787,727,650,2164,085700,0.36367837338262476,0.33595194085027724,0.300369685767098,3
085800,265,481,401,1147,085800,0.23103748910200522,0.41935483870967744,0.34960767218831734,5
085900,789,793,668,2250,085900,0.3506666666666667,0.35244444444444445,0.29688888888888887,1
086000,584,890,840,2314,086000,0.25237683664649957,0.38461538461538464,0.3630077787381158,5
086100,318,357,342,1017,086100,0.31268436578171094,0.35103244837758113,0.336283185840708,3
086200,367,669,444,1480,086200,0.24797297297297297,0.452027027027027,0.3,5
086300,823,896,840,2559,086300,0.3216100039077765,0.35013677217663147,0.32825322391559203,3
086400,464,815,927,2206,086400,0.21033544877606528,0.36944696282864914,0.42021758839528556,5
086500,501,522,497,1520,086500,0.32960526315789473,0.34342105263157896,0.3269736842105263,3
086600,308,526,507,1341,086600,0.2296793437733035,0.39224459358687547,0.378076062639821,5
086800,330,572,474,1376,086800,0.23982558139534885,0.41569767441860467,0.3444767441860465,5
086900,297,278,265,840,086900,0.3535714285714286,0.33095238095238094,0.31547619047619047,3
087000,758,1200,1235,3193,087000,0.2373943000313185,0.3758221108675227,0.3867835891011588,5
087100,361,387,329,1077,087100,0.33519034354688954,0.3593314763231198,0.30547818012999073,3
087200,289,490,537,1316,087200,0.2196048632218845,0.3723404255319149,0.40805471124620063,5
087401,326,570,475,1371,087401,0.23778264040846098,0.41575492341356673,0.3464624361779723,5
087600,188,301,277,766,087600,0.2454308093994778,0.39295039164490864,0.36161879895561355,5
087800,337,504,413,1254,087800,0.2687400318979266,0.4019138755980861,0.3293460925039872,5
088000,943,1541,1551,4035,088000,0.23370508054522923,0.381908302354399,0.38438661710037175,5
088200,629,1132,839,2600,088200,0.24192307692307694,0.43538461538461537,0.32269230769230767,5
088400,1023,1664,2256,4943,088400,0.20695933643536313,0.3366376694315193,0.4564029941331175,5
088600,451,813,629,1893,088600,0.23824617010036978,0.4294770206022187,0.3322768092974115,5
088800,360,730,519,1609,088800,0.22374145431945308,0.4536979490366687,0.3225605966438782,5
088901,1082,1251,1629,3962,088901,0.2730943967693084,0.3157496214033316,0.4111559818273599,5
089000,1072,1800,1715,4587,089000,0.23370394593416177,0.3924133420536298,0.3738827120122084,5
089200,1022,1504,2170,4696,089200,0.2176320272572402,0.3202725724020443,0.4620954003407155,5
089400,324,575,424,1323,089400,0.24489795918367346,0.4346182917611489,0.3204837490551776,5
089600,413,705,454,1572,089600,0.2627226463104326,0.4484732824427481,0.28880407124681934,4
089800,188,341,319,848,089800,0.22169811320754718,0.40212264150943394,0.3761792452830189,5
090000,1094,1620,1602,4316,090000,0.2534754402224282,0.3753475440222428,0.371177015755329,5
090200,332,531,402,1265,090200,0.2624505928853755,0.4197628458498024,0.31778656126482213,5
090600,546,710,415,1671,090600,0.3267504488330341,0.4248952722920407,0.2483542788749252,1
090700,183,235,303,721,090700,0.2538141470180305,0.3259361997226075,0.420249653259362,5
090800,474,563,340,1377,090800,0.3442265795206972,0.40885984023238925,0.24691358024691357,1
091000,811,1106,675,2592,091000,0.3128858024691358,0.42669753086419754,0.2604166666666667,1
091200,763,1186,480,2429,091200,0.31412103746397696,0.48826677645121447,0.19761218608480857,1
091600,481,764,472,1717,091600,0.28013977868375073,0.44496214327315087,0.2748980780430984,4
091601,292,391,1010,1693,091601,0.1724748966331955,0.23095097460129946,0.596574128765505,6
091602,44,61,57,162,091602,0.2716049382716049,0.3765432098765432,0.35185185185185186,5
091800,329,558,393,1280,091800,0.25703125,0.4359375,0.30703125,5
091900,619,734,789,2142,091900,0.28898225957049484,0.3426704014939309,0.36834733893557425,5
092000,727,1033,964,2724,092000,0.2668869309838473,0.3792217327459618,0.35389133627019087,5
092200,424,693,1145,2262,092200,0.1874447391688771,0.3063660477453581,0.5061892130857648,5
092400,343,513,365,1221,092400,0.2809172809172809,0.4201474201474201,0.2989352989352989,4
092500,428,531,544,1503,092500,0.28476380572188953,0.3532934131736527,0.36194278110445777,5
092800,552,825,1279,2656,092800,0.20783132530120482,0.31061746987951805,0.4815512048192771,5
092900,631,932,1167,2730,092900,0.23113553113553115,0.3413919413919414,0.42747252747252745,5
093000,495,704,845,2044,093000,0.24217221135029354,0.34442270058708413,0.41340508806262233,5
093200,148,225,272,645,093200,0.22945736434108527,0.3488372093023256,0.42170542635658914,5
093400,214,399,478,1091,093400,0.19615032080659944,0.36571952337305225,0.4381301558203483,5
093401,325,364,809,1498,093401,0.21695594125500667,0.24299065420560748,0.5400534045393859,6
093402,283,364,688,1335,093402,0.21198501872659176,0.27265917602996254,0.5153558052434457,6
093600,180,322,322,824,093600,0.21844660194174756,0.3907766990291262,0.3907766990291262,5
093800,686,935,1271,2892,093800,0.23720608575380359,0.3233056708160443,0.43948824343015214,5
093900,482,532,806,1820,093900,0.26483516483516484,0.2923076923076923,0.44285714285714284,6
094000,317,303,479,1099,094000,0.28844404003639673,0.275705186533212,0.43585077343039125,6
094201,287,480,549,1316,094201,0.21808510638297873,0.364741641337386,0.41717325227963525,5
094202,423,626,698,1747,094202,0.24212936462507156,0.3583285632512879,0.3995420721236405,5
094203,484,811,1078,2373,094203,0.20396123050990309,0.3417614833544037,0.45427728613569324,5
094401,334,452,642,1428,094401,0.2338935574229692,0.3165266106442577,0.4495798319327731,5
094402,377,537,400,1314,094402,0.286910197869102,0.408675799086758,0.30441400304414,5
094500,430,522,842,1794,094500,0.23968784838350055,0.2909698996655518,0.4693422519509476,6
094600,183,308,393,884,094600,0.20701357466063347,0.34841628959276016,0.4445701357466063,5
094700,294,414,404,1112,094700,0.2643884892086331,0.3723021582733813,0.36330935251798563,5
095000,222,461,403,1086,095000,0.20441988950276244,0.4244935543278085,0.3710865561694291,5
095400,820,1343,1398,3561,095400,0.2302723953945521,0.37714125245717495,0.392586352148273,5
095600,377,653,665,1695,095600,0.2224188790560472,0.3852507374631268,0.39233038348082594,5
095800,383,602,574,1559,095800,0.2456703014753047,0.386144964720975,0.36818473380372035,5
096000,39,61,54,154,096000,0.2532467532467532,0.3961038961038961,0.35064935064935066,5
096200,212,310,289,811,096200,0.26140567200986436,0.38224414303329224,0.3563501849568434,5
096400,571,1000,1071,2642,096400,0.21612414837244512,0.3785011355034065,0.4053747161241484,5
096600,227,417,421,1065,096600,0.2131455399061033,0.39154929577464787,0.39530516431924884,5
096800,171,258,300,729,096800,0.2345679012345679,0.35390946502057613,0.411522633744856,5
097000,232,373,403,1008,097000,0.23015873015873015,0.37003968253968256,0.3998015873015873,5
097202,349,544,330,1223,097202,0.285363859362224,0.4448078495502862,0.2698282910874898,4
097203,724,1022,572,2318,097203,0.31233822260569455,0.44089732528041414,0.24676445211389128,1
097204,284,472,440,1196,097204,0.23745819397993312,0.39464882943143814,0.36789297658862874,5
097300,264,277,506,1047,097300,0.2521489971346705,0.26456542502387775,0.48328557784145176,6
097400,222,399,410,1031,097400,0.21532492725509214,0.38700290979631424,0.3976721629485936,5
098100,275,291,555,1121,098100,0.24531668153434433,0.25958965209634255,0.4950936663693131,6
098200,453,712,541,1706,098200,0.26553341148886284,0.41735052754982416,0.317116060961313,5
098400,172,305,385,862,098400,0.19953596287703015,0.3538283062645012,0.4466357308584687,5
098600,207,386,457,1050,098600,0.19714285714285715,0.3676190476190476,0.43523809523809526,5
098700,258,345,623,1226,098700,0.21044045676998369,0.2814029363784666,0.5081566068515497,6
098800,243,441,461,1145,098800,0.21222707423580786,0.3851528384279476,0.40262008733624455,5
099000,201,269,327,797,099000,0.2521957340025094,0.33751568381430364,0.410288582183187,5
099100,676,741,1733,3150,099100,0.2146031746031746,0.23523809523809525,0.5501587301587302,6
099200,542,839,882,2263,099200,0.23950508174988952,0.37074679628811313,0.3897481219619974,5
099400,176,315,368,859,099400,0.2048894062863795,0.36670547147846333,0.42840512223515714,5
099600,326,553,607,1486,099600,0.2193808882907133,0.3721399730820996,0.4084791386271871,5
099701,280,310,777,1367,099701,0.20482809070958302,0.22677395757132407,0.5683979517190929,6
099703,320,350,883,1553,099703,0.206052801030264,0.22537025112685125,0.5685769478428847,6
099704,580,648,1597,2825,099704,0.20530973451327433,0.22938053097345132,0.5653097345132744,6
099705,232,249,480,961,099705,0.24141519250780438,0.259105098855359,0.4994797086368366,6
099800,347,588,746,1681,099800,0.206424747174301,0.3497917906008328,0.44378346222486614,5
099801,635,1068,955,2658,099801,0.23890142964635064,0.4018058690744921,0.35929270127915724,5
099802,384,651,708,1743,099802,0.22030981067125646,0.37349397590361444,0.40619621342512907,5
099900,57,72,44,173,099900,0.32947976878612717,0.4161849710982659,0.2543352601156069,1
100000,314,358,517,1189,100000,0.2640874684608915,0.3010933557611438,0.4348191757779647,5
100100,638,950,954,2542,100100,0.25098347757671124,0.37372147915027537,0.3752950432730134,5
100200,454,696,879,2029,100200,0.22375554460325284,0.3430261212419911,0.433218334154756,5
100300,529,1028,980,2537,100300,0.2085139929050059,0.4052029956641703,0.38628301143082383,5
100400,706,981,1142,2829,100400,0.2495581477553906,0.34676564156945916,0.40367621067515025,5
100600,859,1376,1594,3829,100600,0.22434055889266127,0.35936275790023503,0.41629668320710367,5
100700,372,555,762,1689,100700,0.2202486678507993,0.3285968028419183,0.4511545293072824,5
100800,761,1094,1335,3190,100800,0.23855799373040754,0.34294670846394987,0.41849529780564265,5
100801,195,350,349,894,100801,0.2181208053691275,0.39149888143176736,0.39038031319910516,5
100802,637,1145,930,2712,100802,0.234882005899705,0.4221976401179941,0.34292035398230086,5
100900,648,854,803,2305,100900,0.2811279826464208,0.37049891540130153,0.34837310195227766,5
101000,744,998,1348,3090,101000,0.2407766990291262,0.32297734627831715,0.4362459546925566,5
101001,788,1318,1035,3141,101001,0.25087551735116204,0.41961158866602993,0.32951289398280803,5
101002,284,372,573,1229,101002,0.23108218063466232,0.30268510984540276,0.4662327095199349,5
101100,103,60,93,256,101100,0.40234375,0.234375,0.36328125,2
101200,179,335,412,926,101200,0.19330453563714903,0.3617710583153348,0.4449244060475162,5
101300,389,458,313,1160,101300,0.3353448275862069,0.39482758620689656,0.26982758620689656,1
101400,481,633,873,1987,101400,0.2420734776044288,0.31857070961248113,0.4393558127830901,5
101600,316,585,529,1430,101600,0.22097902097902097,0.4090909090909091,0.36993006993006994,5
101700,1074,1459,2365,4898,101700,0.21927317272356064,0.29787668436096365,0.4828501429154757,6
101800,743,1096,1371,3210,101800,0.23146417445482867,0.3414330218068536,0.42710280373831777,5
101900,735,1033,1298,3066,101900,0.23972602739726026,0.33692106979778214,0.4233529028049576,5
102000,505,799,1003,2307,102000,0.21889900303424362,0.3463372345036844,0.43476376246207193,5
102100,265,347,399,1011,102100,0.26211671612265086,0.34322453016815035,0.39465875370919884,5
102200,584,850,750,2184,102200,0.2673992673992674,0.3891941391941392,0.3434065934065934,5
102400,211,310,409,930,102400,0.22688172043010751,0.3333333333333333,0.4397849462365591,5
102600,249,385,478,1112,102600,0.2239208633093525,0.3462230215827338,0.42985611510791366,5
102800,141,250,292,683,102800,0.20644216691068815,0.36603221083455345,0.42752562225475843,5
102900,326,375,649,1350,102900,0.2414814814814815,0.2777777777777778,0.48074074074074075,6
103201,576,869,550,1995,103201,0.2887218045112782,0.4355889724310777,0.2756892230576441,4
103202,455,782,730,1967,103202,0.2313167259786477,0.39755973563802743,0.37112353838332485,5
103300,401,465,938,1804,103300,0.2222838137472284,0.25776053215077604,0.5199556541019955,6
103400,437,609,456,1502,103400,0.29094540612516645,0.4054593874833555,0.303595206391478,5
103900,588,799,1313,2700,103900,0.21777777777777776,0.2959259259259259,0.4862962962962963,6
104700,740,895,1289,2924,104700,0.253077975376197,0.3060875512995896,0.4408344733242134,5
105801,693,1165,1084,2942,105801,0.2355540448674371,0.39598912304554723,0.36845683208701563,5
105804,683,1084,1036,2803,105804,0.24366749910809846,0.3867285051730289,0.36960399571887265,5
105900,408,512,872,1792,105900,0.22767857142857142,0.2857142857142857,0.48660714285714285,6
107000,112,128,186,426,107000,0.26291079812206575,0.3004694835680751,0.43661971830985913,5
107201,216,322,557,1095,107201,0.19726027397260273,0.29406392694063926,0.508675799086758,6
107202,41,66,61,168,107202,0.24404761904761904,0.39285714285714285,0.3630952380952381,5
107800,330,514,860,1704,107800,0.1936619718309859,0.30164319248826293,0.5046948356807511,5
108500,212,343,592,1147,108500,0.18482999128160418,0.2990409764603313,0.5161290322580645,6
109300,256,387,672,1315,109300,0.19467680608365018,0.29429657794676806,0.5110266159695818,6
109700,176,236,498,910,109700,0.1934065934065934,0.25934065934065936,0.5472527472527473,6
109800,224,328,265,817,109800,0.2741738066095471,0.401468788249694,0.3243574051407589,5
109900,277,387,797,1461,109900,0.189596167008898,0.2648870636550308,0.5455167693360712,6
110003,344,380,743,1467,110003,0.23449216087252897,0.25903203817314246,0.5064758009543285,6
110004,187,247,362,796,110004,0.23492462311557788,0.3103015075376884,0.4547738693467337,5
110005,236,241,430,907,110005,0.26019845644983464,0.2657111356119074,0.474090407938258,6
110101,228,237,938,1403,110101,0.16250890947968638,0.16892373485388454,0.6685673556664291,6
110102,447,454,1476,2377,110102,0.18805216659655027,0.19099705511148507,0.6209507782919647,6
110200,460,493,1412,2365,110200,0.1945031712473573,0.2084566596194503,0.5970401691331924,6
110300,453,466,1353,2272,110300,0.1993838028169014,0.2051056338028169,0.5955105633802817,6
110400,467,713,571,1751,110400,0.26670474014848655,0.40719588806396345,0.32609937178755,5
110401,262,246,743,1251,110401,0.20943245403677058,0.19664268585131894,0.5939248601119105,6
110402,311,317,940,1568,110402,0.19834183673469388,0.20216836734693877,0.5994897959183674,6
110501,305,331,905,1541,110501,0.19792342634652824,0.21479558728098638,0.5872809863724854,6
110502,328,322,856,1506,110502,0.21779548472775564,0.21381142098273573,0.5683930942895087,6
110600,1233,1446,2632,5311,110600,0.23215966861231407,0.2722651101487479,0.49557522123893805,6
110801,215,199,614,1028,110801,0.20914396887159534,0.193579766536965,0.5972762645914397,6
110803,602,553,1692,2847,110803,0.2114506498068142,0.19423955040393395,0.5943097997892518,6
110901,268,271,886,1425,110901,0.1880701754385965,0.19017543859649122,0.6217543859649123,6
110902,442,653,980,2075,110902,0.2130120481927711,0.3146987951807229,0.472289156626506,5
111000,334,597,353,1284,111000,0.2601246105919003,0.4649532710280374,0.2749221183800623,4
111001,227,242,667,1136,111001,0.19982394366197184,0.2130281690140845,0.5871478873239436,6
111002,502,711,1018,2231,111002,0.22501120573733752,0.31869116987897805,0.45629762438368443,5
111100,1128,1514,1747,4389,111100,0.25700615174299385,0.3449532923217134,0.39804055593529275,5
111201,429,600,804,1833,111201,0.23404255319148937,0.32733224222585927,0.4386252045826514,5
111202,509,676,1333,2518,111202,0.20214455917394758,0.26846703733121524,0.5293884034948372,6
111300,645,727,1848,3220,111300,0.20031055900621117,0.22577639751552794,0.5739130434782609,6
111401,147,187,456,790,111401,0.1860759493670886,0.23670886075949368,0.5772151898734177,6
111402,545,584,1416,2545,111402,0.21414538310412573,0.2294695481335953,0.556385068762279,6
111503,447,468,1167,2082,111503,0.21469740634005763,0.22478386167146974,0.5605187319884726,6
111504,163,157,435,755,111504,0.21589403973509932,0.20794701986754968,0.5761589403973509,6
111505,761,887,1674,3322,111505,0.22907886815171583,0.2670078266104756,0.5039133052378085,6
111506,433,482,988,1903,111506,0.2275354703100368,0.25328428796636887,0.5191802417235943,6
111600,285,464,357,1106,111600,0.2576853526220615,0.41952983725135623,0.3227848101265823,5
111601,466,433,1102,2001,111601,0.23288355822088955,0.21639180409795103,0.5507246376811594,6
111602,380,341,990,1711,111602,0.22209234365867914,0.19929865575686734,0.5786090005844535,6
111701,646,628,1708,2982,111701,0.21663313212608987,0.21059691482226695,0.5727699530516432,6
111703,361,361,943,1665,111703,0.2168168168168168,0.2168168168168168,0.5663663663663664,6
111704,383,334,974,1691,111704,0.22649319929036074,0.19751626256652868,0.5759905381431106,6
111800,258,406,340,1004,111800,0.25697211155378485,0.4043824701195219,0.3386454183266932,5
111801,679,648,1811,3138,111801,0.21637985978330146,0.20650095602294455,0.577119184193754,6
111802,309,344,851,1504,111802,0.20545212765957446,0.22872340425531915,0.5658244680851063,6
111803,348,301,827,1476,111803,0.23577235772357724,0.20392953929539295,0.5602981029810298,6
111804,301,295,736,1332,111804,0.22597597597597596,0.22147147147147148,0.5525525525525525,6
111900,518,569,1596,2683,111900,0.19306746179649645,0.2120760342899739,0.5948565039135296,6
112000,265,548,356,1169,112000,0.22668947818648416,0.46877673224978617,0.3045337895637297,5
112001,515,626,1405,2546,112001,0.20227808326787117,0.24587588373919875,0.5518460329929301,6
112002,476,549,1454,2479,112002,0.1920129084308189,0.22146026623638565,0.5865268253327954,6
112102,342,366,1055,1763,112102,0.19398752127056154,0.20760068065796938,0.598411798071469,6
112103,505,466,1224,2195,112103,0.23006833712984054,0.2123006833712984,0.5576309794988611,6
112104,259,223,767,1249,112104,0.20736589271417133,0.17854283426741394,0.6140912730184147,6
112200,324,566,366,1256,112200,0.25796178343949044,0.45063694267515925,0.2914012738853503,4
112204,347,351,1111,1809,112204,0.19181868435599778,0.19402985074626866,0.6141514648977335,6
112206,635,736,2179,3550,112206,0.17887323943661973,0.20732394366197182,0.6138028169014085,6
112210,730,798,2020,3548,112210,0.20574971815107101,0.22491544532130778,0.5693348365276212,6
112211,455,410,1261,2126,112211,0.21401693320790216,0.19285042333019756,0.5931326434619003,6
112212,331,358,938,1627,112212,0.2034419176398279,0.22003687768899816,0.576521204671174,6
112213,505,541,1569,2615,112213,0.1931166347992352,0.2068833652007648,0.6,6
112214,584,598,1687,2869,112214,0.20355524573021958,0.20843499477169747,0.588009759498083,6
112300,203,235,508,946,112300,0.21458773784355178,0.24841437632135308,0.5369978858350951,6
112400,390,611,453,1454,112400,0.26822558459422285,0.4202200825309491,0.3115543328748281,5
112600,400,661,445,1506,112600,0.2656042496679947,0.4389110225763612,0.2954847277556441,4
112800,392,695,404,1491,112800,0.26291079812206575,0.466130114017438,0.27095908786049633,4
112900,193,248,554,995,112900,0.19396984924623115,0.2492462311557789,0.5567839195979899,6
113000,413,684,496,1593,113000,0.25925925925925924,0.4293785310734463,0.3113622096672944,5
113200,194,425,344,963,113200,0.20145379023883697,0.44132917964693663,0.3572170301142264,5
113300,165,182,424,771,113300,0.2140077821011673,0.23605706874189364,0.5499351491569391,6
113400,302,456,256,1014,113400,0.2978303747534517,0.44970414201183434,0.252465483234714,4
113900,271,341,706,1318,113900,0.20561456752655538,0.25872534142640363,0.5356600910470409,6
114100,278,315,657,1250,114100,0.2224,0.252,0.5256,6
114201,200,297,261,758,114201,0.2638522427440633,0.391820580474934,0.34432717678100266,5
114202,271,436,392,1099,114202,0.24658780709736125,0.39672429481346677,0.35668789808917195,5
114400,285,454,277,1016,114400,0.28051181102362205,0.4468503937007874,0.27263779527559057,4
114600,283,502,340,1125,114600,0.25155555555555553,0.44622222222222224,0.3022222222222222,5
114700,213,204,462,879,114700,0.24232081911262798,0.23208191126279865,0.5255972696245734,6
115000,292,481,378,1151,115000,0.2536924413553432,0.41789748045178104,0.32841007819287577,5
115100,170,191,362,723,115100,0.2351313969571231,0.2641770401106501,0.5006915629322268,6
115200,308,482,366,1156,115200,0.2664359861591695,0.41695501730103807,0.3166089965397924,5
115500,243,349,378,970,115500,0.25051546391752577,0.3597938144329897,0.38969072164948454,5
115600,435,772,428,1635,115600,0.26605504587155965,0.47217125382263,0.2617737003058104,4
115700,383,480,595,1458,115700,0.2626886145404664,0.3292181069958848,0.40809327846364885,5
115800,284,477,377,1138,115800,0.24956063268892795,0.4191564147627416,0.3312829525483304,5
115900,487,510,591,1588,115900,0.3066750629722922,0.3211586901763224,0.3721662468513854,3
116000,280,416,336,1032,116000,0.2713178294573643,0.40310077519379844,0.32558139534883723,5
116100,532,599,556,1687,116100,0.3153526970954357,0.35506816834617666,0.32957913455838767,3
116200,226,402,338,966,116200,0.23395445134575568,0.4161490683229814,0.3498964803312629,5
116300,989,1178,943,3110,116300,0.3180064308681672,0.3787781350482315,0.3032154340836013,3
116400,311,466,435,1212,116400,0.2566006600660066,0.3844884488448845,0.3589108910891089,5
116600,288,465,313,1066,116600,0.2701688555347092,0.43621013133208253,0.29362101313320826,4
116700,274,298,227,799,116700,0.3429286608260325,0.37296620775969963,0.28410513141426785,1
116800,225,353,207,785,116800,0.28662420382165604,0.4496815286624204,0.26369426751592356,4
117000,202,385,203,790,117000,0.25569620253164554,0.4873417721518987,0.2569620253164557,4
117100,327,390,414,1131,117100,0.2891246684350133,0.3448275862068966,0.3660477453580902,5
117201,235,507,327,1069,117201,0.21983161833489243,0.47427502338634236,0.3058933582787652,5
117202,375,673,471,1519,117202,0.2468729427254773,0.44305464121132326,0.31007241606319946,5
117400,409,721,505,1635,117400,0.25015290519877675,0.44097859327217126,0.308868501529052,5
117500,547,558,1007,2112,117500,0.2589962121212121,0.26420454545454547,0.47679924242424243,6
117601,303,503,350,1156,117601,0.26211072664359863,0.435121107266436,0.3027681660899654,5
117602,297,564,367,1228,117602,0.24185667752442996,0.4592833876221498,0.2988599348534202,4
117800,185,354,201,740,117800,0.25,0.4783783783783784,0.2716216216216216,4
118000,47,61,64,172,118000,0.27325581395348836,0.3546511627906977,0.37209302325581395,5
118100,213,251,424,888,118100,0.23986486486486486,0.28265765765765766,0.4774774774774775,6
118201,326,566,368,1260,118201,0.25873015873015875,0.4492063492063492,0.2920634920634921,4
118202,301,543,350,1194,118202,0.2520938023450586,0.4547738693467337,0.2931323283082077,4
118400,417,794,593,1804,118400,0.2311529933481153,0.4401330376940133,0.3287139689578714,5
118500,255,321,279,855,118500,0.2982456140350877,0.37543859649122807,0.3263157894736842,5
118600,306,556,408,1270,118600,0.2409448818897638,0.4377952755905512,0.32125984251968503,5
118700,353,346,383,1082,118700,0.32624768946395566,0.3197781885397412,0.3539741219963031,3
118800,636,788,460,1884,118800,0.3375796178343949,0.4182590233545648,0.24416135881104034,1
118900,307,343,312,962,118900,0.3191268191268191,0.35654885654885654,0.32432432432432434,3
119000,249,362,257,868,119000,0.2868663594470046,0.41705069124423966,0.2960829493087558,4
119100,419,520,442,1381,119100,0.30340333091962346,0.3765387400434468,0.32005792903692976,3
119200,285,522,343,1150,119200,0.24782608695652175,0.4539130434782609,0.2982608695652174,4
119300,233,305,422,960,119300,0.24270833333333333,0.3177083333333333,0.4395833333333333,5
119400,429,602,479,1510,119400,0.28410596026490065,0.39867549668874175,0.3172185430463576,5
119500,171,228,347,746,119500,0.2292225201072386,0.30563002680965146,0.4651474530831099,5
119600,583,866,644,2093,119600,0.27854753941710464,0.41376015289058765,0.3076923076923077,5
119800,365,613,374,1352,119800,0.26997041420118345,0.45340236686390534,0.27662721893491127,4
119900,224,241,300,765,119900,0.2928104575163399,0.3150326797385621,0.39215686274509803,5
120000,538,704,831,2073,120000,0.2595272551857212,0.3396044380125422,0.40086830680173663,5
120100,231,288,235,754,120100,0.3063660477453581,0.3819628647214854,0.3116710875331565,3
120200,241,339,267,847,120200,0.2845336481700118,0.4002361275088548,0.3152302243211334,5
120300,241,230,292,763,120300,0.31585845347313235,0.30144167758846657,0.382699868938401,3
120500,359,423,317,1099,120500,0.32666060054595086,0.3848953594176524,0.28844404003639673,1
120700,344,376,612,1332,120700,0.25825825825825827,0.2822822822822823,0.4594594594594595,6
120800,818,1377,1079,3274,120800,0.24984728161270617,0.4205864386072083,0.3295662797800855,5
121000,505,727,392,1624,121000,0.31096059113300495,0.4476600985221675,0.2413793103448276,1
121100,47,53,56,156,121100,0.30128205128205127,0.33974358974358976,0.358974358974359,3
121400,441,704,399,1544,121400,0.2856217616580311,0.45595854922279794,0.25841968911917096,4
121500,466,556,609,1631,121500,0.2857142857142857,0.34089515634580014,0.37339055793991416,5
122000,496,825,797,2118,122000,0.23418319169027385,0.3895184135977337,0.37629839471199245,5
122300,867,994,1790,3651,122300,0.23746918652423993,0.2722541769378253,0.4902766365379348,6
122403,311,471,574,1356,122403,0.22935103244837757,0.3473451327433628,0.42330383480825956,5
122404,489,614,944,2047,122404,0.23888617489008304,0.29995114802149486,0.46116267708842207,6
122405,381,628,735,1744,122405,0.2184633027522936,0.36009174311926606,0.42144495412844035,5
122406,593,1082,886,2561,122406,0.23155017571261227,0.42249121436938697,0.34595860991800076,5
122501,545,851,751,2147,122501,0.25384257102934327,0.39636702375407545,0.3497904052165813,5
122502,733,1078,1080,2891,122502,0.25354548599100657,0.3728813559322034,0.37357315807679004,5
122601,737,887,1479,3103,122601,0.23751208507895585,0.2858524009023526,0.4766355140186916,6
122602,567,620,1180,2367,122602,0.23954372623574144,0.2619349387410224,0.49852133502323615,6
122603,671,780,1618,3069,122603,0.21863799283154123,0.2541544477028348,0.527207559465624,6
122701,995,1221,2166,4382,122701,0.22706526700136923,0.2786398904609767,0.49429484253765404,6
122702,674,903,922,2499,122702,0.26970788315326133,0.36134453781512604,0.3689475790316126,5
122704,280,357,493,1130,122704,0.24778761061946902,0.315929203539823,0.43628318584070797,5
122705,380,490,774,1644,122705,0.23114355231143552,0.2980535279805353,0.4708029197080292,6
122706,403,571,950,1924,122706,0.20945945945945946,0.29677754677754675,0.49376299376299376,6
122707,397,463,865,1725,122707,0.2301449275362319,0.2684057971014493,0.5014492753623189,6
122801,688,924,1226,2838,122801,0.24242424242424243,0.32558139534883723,0.4319943622269204,5
122802,554,666,1105,2325,122802,0.23827956989247312,0.2864516129032258,0.4752688172043011,6
122901,677,905,1650,3232,122901,0.2094678217821782,0.28001237623762376,0.510519801980198,6
122902,483,707,1255,2445,122902,0.19754601226993865,0.28916155419222905,0.5132924335378323,6
123001,645,804,1600,3049,123001,0.21154476877664807,0.26369301410298457,0.5247622171203673,6
123002,513,707,1202,2422,123002,0.21180842279108175,0.29190751445086704,0.4962840627580512,6
123101,413,516,1030,1959,123101,0.21082184788157224,0.26339969372128635,0.5257784583971414,6
123102,518,526,1174,2218,123102,0.23354373309287646,0.23715058611361586,0.5293056807935077,6
123201,265,495,467,1227,123201,0.21597392013039934,0.4034229828850856,0.38060309698451505,5
123202,956,1812,1546,4314,123202,0.22160407974038016,0.4200278164116829,0.35836810384793694,5
123301,893,1407,1231,3531,123301,0.2529028603794959,0.39847068819031434,0.3486264514301897,5
123302,255,485,356,1096,123302,0.23266423357664234,0.4425182481751825,0.3248175182481752,5
123401,524,749,1032,2305,123401,0.22733188720173536,0.3249457700650759,0.4477223427331887,5
123402,906,1202,1677,3785,123402,0.2393659180977543,0.31756935270805814,0.4430647291941876,5
123500,630,853,1273,2756,123500,0.22859216255442671,0.3095065312046444,0.4619013062409289,5
123600,396,435,982,1813,123600,0.21842250413678985,0.2399338113623828,0.5416436845008273,6
123700,933,639,532,2104,123700,0.44344106463878324,0.30370722433460073,0.25285171102661597,1
123701,768,1517,1120,3405,123701,0.22555066079295155,0.44552129221732745,0.328928046989721,5
123702,910,1475,1698,4083,123702,0.22287533676218466,0.3612539799167279,0.41587068332108745,5
123801,430,590,1024,2044,123801,0.21037181996086105,0.28864970645792565,0.5009784735812133,6
123802,375,470,887,1732,123802,0.21651270207852194,0.27136258660508084,0.5121247113163973,6
123900,627,717,1186,2530,123900,0.24782608695652175,0.283399209486166,0.46877470355731227,6
124001,506,674,1231,2411,124001,0.2098714226462049,0.27955205309000414,0.510576524263791,6
124002,409,499,880,1788,124002,0.22874720357941836,0.279082774049217,0.49217002237136465,6
124100,360,485,793,1638,124100,0.21978021978021978,0.2960927960927961,0.48412698412698413,6
124101,564,710,1220,2494,124101,0.22614274258219727,0.2846832397754611,0.48917401764234164,6
124102,395,476,982,1853,124102,0.21316783594171615,0.25688073394495414,0.5299514301133297,6
124200,663,832,1553,3048,124200,0.21751968503937008,0.27296587926509186,0.509514435695538,6
124300,758,905,1775,3438,124300,0.22047702152414195,0.26323443862710877,0.5162885398487492,6
124401,404,502,1013,1919,124401,0.21052631578947367,0.26159458051068263,0.5278791036998437,6
124402,462,492,1001,1955,124402,0.23631713554987213,0.25166240409207163,0.5120204603580563,6
124500,547,639,1406,2592,124500,0.21103395061728394,0.2465277777777778,0.5424382716049383,6
124601,313,287,779,1379,124601,0.22697606961566352,0.20812182741116753,0.564902102973169,6
124602,424,444,1313,2181,124602,0.19440623567171023,0.20357634112792297,0.6020174232003668,6
124700,366,446,808,1620,124700,0.22592592592592592,0.27530864197530863,0.49876543209876545,6
125700,349,393,536,1278,125700,0.2730829420970266,0.3075117370892019,0.4194053208137715,5
126500,195,252,358,805,126500,0.2422360248447205,0.3130434782608696,0.44472049689440996,5
126700,309,405,592,1306,126700,0.23660030627871362,0.3101071975497703,0.45329249617151607,5
127700,332,381,928,1641,127700,0.20231566118220598,0.23217550274223034,0.5655088360755637,6
128300,43,49,57,149,128300,0.28859060402684567,0.3288590604026846,0.3825503355704698,5
129102,290,361,848,1499,129102,0.1934623082054703,0.2408272181454303,0.5657104736490994,6
129103,349,411,927,1687,129103,0.20687611144042678,0.24362774155305275,0.5494961470065205,6
129104,319,400,902,1621,129104,0.19679210363972857,0.24676125848241826,0.5564466378778532,6
130003,554,625,1280,2459,130003,0.22529483529890199,0.2541683611224075,0.5205368035786905,6
130004,202,224,522,948,130004,0.21308016877637131,0.23628691983122363,0.5506329113924051,6
130005,292,371,736,1399,130005,0.2087205146533238,0.2651894210150107,0.5260900643316655,6
130100,339,525,956,1820,130100,0.18626373626373627,0.28846153846153844,0.5252747252747253,6
133300,347,414,886,1647,133300,0.21068609593199758,0.25136612021857924,0.5379477838494232,6
133900,142,172,334,648,133900,0.2191358024691358,0.2654320987654321,0.5154320987654321,6
134100,369,398,665,1432,134100,0.25768156424581007,0.2779329608938548,0.4643854748603352,6
134700,732,1059,1755,3546,134700,0.20642978003384094,0.2986463620981388,0.4949238578680203,6
134702,620,693,1733,3046,134702,0.2035456336178595,0.22751149047931712,0.5689428759028233,6
134703,400,378,1133,1911,134703,0.20931449502878074,0.1978021978021978,0.5928833071690215,6
134704,265,287,745,1297,134704,0.20431765612952968,0.2212798766383963,0.574402467232074,6
134902,527,483,1373,2383,134902,0.22114981116240034,0.20268569030633654,0.5761644985312631,6
134903,139,132,427,698,134903,0.1991404011461318,0.18911174785100288,0.6117478510028653,6
134904,759,674,1808,3241,134904,0.2341869793273681,0.20796050601666152,0.5578525146559704,6
134906,578,526,1572,2676,134906,0.21599402092675635,0.19656203288490284,0.5874439461883408,6
134907,395,414,1185,1994,134907,0.19809428284854563,0.20762286860581744,0.594282848545637,6
135002,591,609,1551,2751,135002,0.2148309705561614,0.22137404580152673,0.5637949836423118,6
135003,534,470,1505,2509,135003,0.2128337983260263,0.1873256277401355,0.5998405739338382,6
135004,318,367,956,1641,135004,0.19378427787934185,0.22364411943936624,0.5825716026812919,6
135005,290,335,918,1543,135005,0.1879455605962411,0.21710952689565782,0.5949449125081011,6
135101,362,448,1127,1937,135101,0.1868869385647909,0.23128549303045948,0.5818275684047496,6
135102,500,499,1313,2312,135102,0.21626297577854672,0.21583044982698962,0.5679065743944637,6
135103,539,504,1418,2461,135103,0.2190166598943519,0.2047947988622511,0.576188541243397,6
135104,525,551,1543,2619,135104,0.2004581901489118,0.2103856433753341,0.5891561664757541,6
135201,274,262,684,1220,135201,0.22459016393442624,0.21475409836065573,0.5606557377049181,6
135204,476,448,1327,2251,135204,0.21146157263438473,0.19902265659706797,0.5895157707685473,6
135205,496,517,1379,2392,135205,0.20735785953177258,0.2161371237458194,0.5765050167224081,6
135208,335,325,826,1486,135208,0.22543741588156124,0.21870794078061911,0.5558546433378196,6
135209,350,353,992,1695,135209,0.20648967551622419,0.20825958702064898,0.5852507374631268,6
135301,407,448,1118,1973,135301,0.20628484541307654,0.22706538266599088,0.5666497719209326,6
135303,499,471,1150,2120,135303,0.23537735849056604,0.22216981132075472,0.5424528301886793,6
135304,408,377,1050,1835,135304,0.2223433242506812,0.20544959128065396,0.5722070844686649,6
135401,689,659,1912,3260,135401,0.21134969325153374,0.20214723926380368,0.5865030674846625,6
135402,803,705,2075,3583,135402,0.2241138710577728,0.19676248953391012,0.579123639408317,6
135403,525,580,1394,2499,135403,0.21008403361344538,0.23209283713485393,0.5578231292517006,6
136700,508,638,1149,2295,136700,0.22135076252723312,0.27799564270152505,0.5006535947712418,6
137700,554,764,1283,2601,137700,0.21299500192233756,0.2937331795463283,0.4932718185313341,6
138501,333,523,866,1722,138501,0.19337979094076654,0.3037166085946574,0.502903600464576,5
138502,21,39,39,99,138502,0.21212121212121213,0.3939393939393939,0.3939393939393939,5
139900,138,249,433,820,139900,0.16829268292682928,0.30365853658536585,0.5280487804878049,5
140101,482,555,1025,2062,140101,0.23375363724539283,0.2691561590688652,0.49709020368574197,6
140200,816,1026,1774,3616,140200,0.22566371681415928,0.28373893805309736,0.4905973451327434,6
140300,889,1161,1822,3872,140300,0.22959710743801653,0.29984504132231404,0.4705578512396694,6
140400,528,523,1609,2660,140400,0.19849624060150375,0.19661654135338347,0.6048872180451128,6
140500,304,330,672,1306,140500,0.2327718223583461,0.25267993874425726,0.5145482388973966,6
140602,358,406,811,1575,140602,0.2273015873015873,0.2577777777777778,0.5149206349206349,6
140700,736,818,1628,3182,140700,0.23130106851037083,0.257071024512885,0.5116279069767442,6
140801,338,339,631,1308,140801,0.25840978593272174,0.2591743119266055,0.48241590214067276,6
140901,106,137,220,463,140901,0.22894168466522677,0.2958963282937365,0.47516198704103674,6
140902,278,284,500,1062,140902,0.2617702448210923,0.2674199623352166,0.4708097928436911,6
141700,367,548,916,1831,141700,0.2004369197160022,0.2992900054614965,0.5002730748225014,6
142900,377,427,755,1559,142900,0.2418216805644644,0.2738935214881334,0.4842847979474022,6
143500,223,255,435,913,143500,0.244249726177437,0.2792990142387733,0.4764512595837897,6
144100,249,343,694,1286,144100,0.19362363919129083,0.2667185069984448,0.5396578538102644,6
144700,315,398,610,1323,144700,0.23809523809523808,0.30083144368858655,0.46107331821617537,5
145101,154,173,278,605,145101,0.2545454545454545,0.2859504132231405,0.45950413223140496,6
145102,234,301,516,1051,145102,0.2226450999048525,0.28639391056137015,0.49096098953377737,6
145602,640,1423,1020,3083,145602,0.2075900097307817,0.46156341226078496,0.33084657800843337,5
145603,629,1379,962,2970,145603,0.2117845117845118,0.4643097643097643,0.3239057239057239,5
145604,485,1045,761,2291,145604,0.21169794849410736,0.4561326931470973,0.3321693583587953,5
145605,425,858,575,1858,145605,0.22874058127018299,0.46178686759956944,0.3094725511302476,5
145701,615,692,1459,2766,145701,0.22234273318872017,0.2501807664497469,0.5274765003615329,6
145702,687,1371,996,3054,145702,0.224950884086444,0.4489194499017682,0.32612966601178783,5
145703,596,1196,866,2658,145703,0.22422874341610233,0.44996237772761477,0.3258088788562829,5
145704,831,1438,1413,3682,145704,0.22569255839217817,0.39054861488321563,0.3837588267246062,5
145803,499,553,1280,2332,145803,0.2139794168096055,0.23713550600343053,0.548885077186964,6
145804,432,650,784,1866,145804,0.2315112540192926,0.3483386923901393,0.42015005359056806,5
145805,656,834,1562,3052,145805,0.21494102228047182,0.2732634338138925,0.5117955439056356,6
145807,500,634,1226,2360,145807,0.211864406779661,0.26864406779661015,0.5194915254237288,6
145808,358,507,913,1778,145808,0.2013498312710911,0.28515185601799775,0.5134983127109112,6
145900,295,372,596,1263,145900,0.23357086302454474,0.29453681710213775,0.4718923198733175,6
145901,395,612,722,1729,145901,0.22845575477154426,0.3539618276460382,0.4175824175824176,5
145902,866,1758,1297,3921,145902,0.22086202499362406,0.4483550114766641,0.3307829635297118,5
145903,676,820,1366,2862,145903,0.23619846261355695,0.286512928022362,0.4772886093640811,6
146001,487,1117,680,2284,146001,0.21322241681260945,0.4890542907180385,0.29772329246935203,4
146002,623,1118,845,2586,146002,0.24091260634184067,0.4323279195668987,0.32675947409126066,5
146003,950,1357,1596,3903,146003,0.2434025108890597,0.34768127081732003,0.4089162182936203,5
146102,306,572,426,1304,146102,0.23466257668711657,0.4386503067484663,0.3266871165644172,5
146103,492,552,1131,2175,146103,0.22620689655172413,0.2537931034482759,0.52,6
146105,766,1471,1018,3255,146105,0.23533026113671274,0.4519201228878648,0.31274961597542245,5
146106,482,1005,742,2229,146106,0.21624046657694032,0.4508748317631225,0.33288470165993717,5
146201,529,1100,709,2338,146201,0.2262617621899059,0.4704875962360992,0.3032506415739949,5
146202,541,1052,759,2352,146202,0.23001700680272108,0.44727891156462585,0.3227040816326531,5
146203,659,1145,956,2760,146203,0.23876811594202899,0.4148550724637681,0.3463768115942029,5
146204,719,1345,1047,3111,146204,0.2311153969784635,0.4323368691738991,0.3365477338476374,5
146205,292,319,631,1242,146205,0.23510466988727857,0.25684380032206117,0.5080515297906603,6
146206,252,371,605,1228,146206,0.20521172638436483,0.30211726384364823,0.49267100977198697,5
146300,474,623,1140,2237,146300,0.21189092534644613,0.278497988377291,0.5096110862762628,6
146402,558,699,1134,2391,146402,0.23337515683814303,0.29234629861982436,0.4742785445420326,6
146403,534,1008,727,2269,146403,0.2353459673865139,0.44424856765094756,0.3204054649625386,5
146404,396,720,662,1778,146404,0.22272215973003376,0.4049493813273341,0.37232845894263217,5
146500,567,731,1499,2797,146500,0.20271719699678226,0.26135144797997856,0.5359313550232392,6
146604,565,663,1430,2658,146604,0.2125658389766742,0.24943566591422123,0.5379984951091046,6
146605,128,166,348,642,146605,0.19937694704049844,0.2585669781931464,0.5420560747663551,6
146606,783,929,2101,3813,146606,0.2053501180173092,0.24364017833726725,0.5510097036454236,6
146607,323,405,757,1485,146607,0.2175084175084175,0.2727272727272727,0.5097643097643098,6
146608,263,348,768,1379,146608,0.19071791153009426,0.252356780275562,0.5569253081943437,6
146611,331,421,1018,1770,146611,0.18700564971751413,0.23785310734463277,0.5751412429378531,6
146612,612,670,1479,2761,146612,0.22165881926838102,0.24266570083303152,0.5356754798985874,6
146613,486,562,1018,2066,146613,0.23523717328170377,0.27202323330106487,0.4927395934172314,6
146614,670,705,1750,3125,146614,0.2144,0.2256,0.56,6
146615,589,675,1484,2748,146615,0.21433770014556042,0.24563318777292575,0.5400291120815138,6
146700,242,330,583,1155,146700,0.20952380952380953,0.2857142857142857,0.5047619047619047,6
146703,489,754,857,2100,146703,0.23285714285714285,0.35904761904761906,0.4080952380952381,5
146704,222,289,610,1121,146704,0.19803746654772525,0.25780553077609275,0.544157002676182,6
146705,385,423,960,1768,146705,0.21776018099547512,0.23925339366515838,0.5429864253393665,6
146706,310,424,769,1503,146706,0.20625415834996674,0.2821024617431803,0.5116433799068529,6
146800,642,796,1720,3158,146800,0.2032932235592147,0.2520582647245092,0.5446485117162762,6
146901,597,697,1517,2811,146901,0.21237993596584845,0.247954464603344,0.5396655994308075,6
146902,414,413,1156,1983,146902,0.2087745839636914,0.20827029752899648,0.5829551185073122,6
147001,503,503,1295,2301,147001,0.2186006084311169,0.2186006084311169,0.5627987831377662,6
147003,432,542,1327,2301,147003,0.1877444589308996,0.23554976097348979,0.5767057800956106,6
147004,34,46,91,171,147004,0.19883040935672514,0.26900584795321636,0.5321637426900585,6
147100,637,712,1525,2874,147100,0.22164231036882392,0.2477383437717467,0.5306193458594294,6
147200,686,869,1466,3021,147200,0.22707712677921219,0.2876530950016551,0.48526977821913275,6
147300,728,1104,1542,3374,147300,0.2157676348547718,0.3272080616478957,0.45702430349733253,5
147401,750,875,1645,3270,147401,0.22935779816513763,0.26758409785932724,0.5030581039755352,6
147402,420,416,1046,1882,147402,0.22316684378320936,0.22104144527098832,0.5557917109458024,6
147501,806,963,2247,4016,147501,0.20069721115537847,0.23979083665338646,0.5595119521912351,6
147502,776,803,1794,3373,147502,0.23006225911651348,0.23806700266824785,0.5318707382152387,6
147503,160,146,460,766,147503,0.20887728459530025,0.1906005221932115,0.6005221932114883,6
147601,267,288,796,1351,147601,0.19763138415988157,0.21317542561065878,0.5891931902294597,6
147602,573,626,1525,2724,147602,0.21035242290748898,0.22980910425844348,0.5598384728340675,6
147701,407,487,959,1853,147701,0.21964382083108472,0.26281705342687534,0.51753912574204,6
147702,656,584,1354,2594,147702,0.2528912875867386,0.2251349267540478,0.5219737856592136,6
147802,408,414,1097,1919,147802,0.2126107347576863,0.21573736321000522,0.5716519020323085,6
147803,338,411,841,1590,147803,0.21257861635220127,0.25849056603773585,0.5289308176100629,6
147804,583,619,1796,2998,147804,0.19446297531687792,0.20647098065376918,0.5990660440293529,6
147900,317,435,898,1650,147900,0.1921212121212121,0.2636363636363636,0.5442424242424242,6
147901,494,566,1292,2352,147901,0.2100340136054422,0.24064625850340135,0.5493197278911565,6
147902,482,511,1250,2243,147902,0.21489077128845296,0.22781988408381632,0.5572893446277307,6
148300,228,278,675,1181,148300,0.1930567315834039,0.23539373412362405,0.5715495342929721,6
150003,216,211,381,808,150003,0.26732673267326734,0.26113861386138615,0.4715346534653465,6
150004,369,416,884,1669,150004,0.22109047333732773,0.24925104853205513,0.5296584781306172,6
150005,283,341,664,1288,150005,0.21972049689440995,0.26475155279503104,0.515527950310559,6
150006,198,239,378,815,150006,0.24294478527607363,0.29325153374233126,0.4638036809815951,6
150100,594,709,688,1991,150100,0.2983425414364641,0.3561024610748368,0.34555499748869917,5
150200,941,1103,1522,3566,150200,0.26388109927089176,0.3093101514301739,0.42680874929893436,5
150300,521,716,637,1874,150300,0.27801494130202775,0.3820704375667022,0.33991462113127,5
150400,359,428,460,1247,150400,0.28789093825180434,0.34322373696872494,0.3688853247794707,5
150500,478,573,545,1596,150500,0.29949874686716793,0.35902255639097747,0.34147869674185466,5
150701,255,331,722,1308,150701,0.19495412844036697,0.2530581039755352,0.5519877675840978,6
150702,227,328,671,1226,150702,0.18515497553017946,0.26753670473083196,0.5473083197389886,6
152200,351,423,791,1565,152200,0.2242811501597444,0.2702875399361022,0.5054313099041533,6
152901,520,651,1307,2478,152901,0.20984665052461662,0.2627118644067797,0.5274414850686037,6
152902,395,554,1227,2176,152902,0.18152573529411764,0.2545955882352941,0.5638786764705882,6
155101,158,226,312,696,155101,0.22701149425287356,0.32471264367816094,0.4482758620689655,5
155102,612,942,1874,3428,155102,0.17852975495915985,0.2747957992998833,0.5466744457409568,6
156700,96,152,223,471,156700,0.20382165605095542,0.3227176220806794,0.4734607218683652,5
157101,659,916,1674,3249,157101,0.2028316405047707,0.28193290243151736,0.5152354570637119,6
157102,219,294,430,943,157102,0.23223753976670203,0.3117709437963945,0.4559915164369035,5
157901,512,655,1183,2350,157901,0.2178723404255319,0.27872340425531916,0.5034042553191489,6
157902,411,535,920,1866,157902,0.2202572347266881,0.2867095391211147,0.4930332261521972,6
157903,473,578,916,1967,157903,0.24046771733604475,0.2938485002541942,0.46568378240976105,6
158001,388,446,1375,2209,158001,0.17564508827523767,0.2019013128112268,0.6224535989135356,6
158002,565,541,1739,2845,158002,0.19859402460456943,0.19015817223198594,0.6112478031634446,6
158006,663,662,1698,3023,158006,0.21931855772411513,0.21898776050281177,0.5616936817730731,6
158007,418,484,1013,1915,158007,0.21827676240208876,0.25274151436031334,0.528981723237598,6
158009,268,262,788,1318,158009,0.20333839150227617,0.19878603945371776,0.5978755690440061,6
158010,339,349,1064,1752,158010,0.1934931506849315,0.19920091324200914,0.6073059360730594,6
158011,429,517,1202,2148,158011,0.19972067039106145,0.24068901303538176,0.5595903165735568,6
158102,615,754,1283,2652,158102,0.2319004524886878,0.28431372549019607,0.48378582202111614,6
158103,516,628,1081,2225,158103,0.23191011235955056,0.28224719101123596,0.4858426966292135,6
158104,642,777,1414,2833,158104,0.22661489587010236,0.2742675608895164,0.4991175432403812,6
158107,457,478,1052,1987,158107,0.2299949672873679,0.24056366381479619,0.5294413688978359,6
158108,311,392,802,1505,158108,0.20664451827242525,0.26046511627906976,0.532890365448505,6
158110,491,572,937,2000,158110,0.2455,0.286,0.4685,6
158111,396,506,812,1714,158111,0.2310385064177363,0.2952158693115519,0.47374562427071176,6
158112,573,674,1050,2297,158112,0.24945581192860253,0.2934262080975185,0.457117979973879,6
158114,456,463,992,1911,158114,0.23861852433281006,0.2422815279958137,0.5190999476713762,6
158115,729,838,1578,3145,158115,0.23179650238473767,0.26645468998410177,0.5017488076311606,6
158116,230,309,485,1024,158116,0.224609375,0.3017578125,0.4736328125,5
158202,908,998,1821,3727,158202,0.24362758250603703,0.2677756909042125,0.48859672658975045,6
158203,149,165,426,740,158203,0.20135135135135135,0.22297297297297297,0.5756756756756757,6
158205,222,197,577,996,158205,0.22289156626506024,0.19779116465863453,0.5793172690763052,6
158206,373,405,1042,1820,158206,0.20494505494505494,0.22252747252747251,0.5725274725274725,6
158207,467,523,1269,2259,158207,0.2067286409915892,0.23151837096060204,0.5617529880478087,6
158304,709,633,1915,3257,158304,0.21768498618360455,0.19435062941357076,0.5879643844028247,6
158306,617,598,1580,2795,158306,0.22075134168157423,0.21395348837209302,0.5652951699463328,6
158308,975,1188,2060,4223,158308,0.2308785223774568,0.2813165995737627,0.4878048780487805,6
158309,498,667,1014,2179,158309,0.22854520422212024,0.3061037173015145,0.4653510784763653,5
158310,458,541,934,1933,158310,0.23693740300051733,0.27987584066218313,0.4831867563372995,6
158315,531,684,1177,2392,158315,0.22198996655518394,0.28595317725752506,0.49205685618729095,6
158317,595,704,1495,2794,158317,0.2129563350035791,0.25196850393700787,0.535075161059413,6
158318,548,523,1223,2294,158318,0.23888404533565824,0.22798605056669574,0.533129904097646,6
158319,452,473,950,1875,158319,0.24106666666666668,0.25226666666666664,0.5066666666666667,6
158320,769,872,1676,3317,158320,0.23183599638227315,0.2628881519445282,0.5052758516731987,6
158321,971,1320,2432,4723,158321,0.2055896675841626,0.27948337920813043,0.514926953207707,6
158322,181,207,506,894,158322,0.20246085011185683,0.23154362416107382,0.5659955257270693,6
158323,712,783,1872,3367,158323,0.21146421146421146,0.23255123255123256,0.555984555984556,6
158401,160,156,390,706,158401,0.22662889518413598,0.22096317280453256,0.5524079320113314,6
158402,437,455,1239,2131,158402,0.2050680431722196,0.21351478179258565,0.5814171750351947,6
158403,261,354,613,1228,158403,0.21254071661237786,0.28827361563517917,0.499185667752443,6
158405,550,593,1440,2583,158405,0.2129307007355788,0.22957801006581494,0.5574912891986062,6
158407,666,721,1527,2914,158407,0.22855181880576528,0.24742621825669184,0.5240219629375429,6
158408,491,542,1040,2073,158408,0.23685479980704294,0.26145682585624697,0.5016883743367101,6
158409,356,478,996,1830,158409,0.19453551912568307,0.2612021857923497,0.5442622950819672,6
158410,271,258,587,1116,158410,0.24283154121863798,0.23118279569892472,0.5259856630824373,6
158502,368,451,809,1628,158502,0.22604422604422605,0.27702702702702703,0.49692874692874694,6
158505,485,531,1108,2124,158505,0.2283427495291902,0.25,0.5216572504708098,6
158506,345,363,676,1384,158506,0.24927745664739884,0.2622832369942196,0.4884393063583815,6
158507,544,578,957,2079,158507,0.26166426166426165,0.278018278018278,0.4603174603174603,6
158508,743,801,1625,3169,158508,0.23445881981697697,0.25276112338277057,0.5127800568002524,6
158509,557,713,1243,2513,158509,0.2216474333465977,0.28372463191404695,0.49462793473935535,6
158510,806,994,1772,3572,158510,0.22564389697648377,0.2782754759238522,0.49608062709966405,6
158511,682,843,1549,3074,158511,0.22186076772934288,0.27423552374756016,0.503903708523097,6
158512,334,433,913,1680,158512,0.1988095238095238,0.2577380952380952,0.5434523809523809,6
158604,599,679,1306,2584,158604,0.23181114551083593,0.2627708978328173,0.5054179566563467,6
158605,547,645,1192,2384,158605,0.2294463087248322,0.27055369127516776,0.5,6
158606,584,716,1266,2566,158606,0.22759158222915044,0.2790335151987529,0.49337490257209665,6
158607,363,442,873,1678,158607,0.2163289630512515,0.2634088200238379,0.5202622169249106,6
158608,404,610,870,1884,158608,0.21443736730360935,0.3237791932059448,0.46178343949044587,5
158609,508,600,1121,2229,158609,0.22790489008524,0.2691790040376851,0.5029161058770749,6
158704,866,1202,1780,3848,158704,0.22505197505197505,0.3123700623700624,0.4625779625779626,5
158705,465,646,806,1917,158705,0.24256651017214398,0.3369848721961398,0.4204486176317162,5
158707,190,273,423,886,158707,0.2144469525959368,0.30812641083521447,0.47742663656884876,5
158708,418,553,900,1871,158708,0.22340994120791022,0.2955638695884554,0.48102618920363444,6
158709,267,306,662,1235,158709,0.21619433198380567,0.24777327935222673,0.5360323886639676,6
158710,445,557,880,1882,158710,0.23645058448459086,0.29596174282678,0.4675876726886291,6
158711,609,685,1306,2600,158711,0.23423076923076924,0.26346153846153847,0.5023076923076923,6
158712,839,1140,1840,3819,158712,0.21969101859125426,0.29850746268656714,0.4818015187221786,6
158802,502,546,1460,2508,158802,0.20015948963317384,0.21770334928229665,0.5821371610845295,6
158803,723,799,1589,3111,158803,0.23240115718418514,0.2568306010928962,0.5107682417229187,6
158804,872,970,1826,3668,158804,0.23773173391494,0.2644492911668484,0.49781897491821153,6
158900,767,1060,1589,3416,158900,0.22453161592505855,0.31030444964871196,0.4651639344262295,5
159000,578,683,1137,2398,159000,0.24103419516263552,0.2848206839032527,0.47414512093411176,6
159102,715,920,1380,3015,159102,0.23714759535655058,0.30514096185737977,0.4577114427860697,5
159103,670,957,1029,2656,159103,0.2522590361445783,0.36031626506024095,0.3874246987951807,5
159105,765,1159,1679,3603,159105,0.21232306411323898,0.32167638079378297,0.46600055509297805,5
159106,599,931,1460,2990,159106,0.2003344481605351,0.311371237458194,0.4882943143812709,5
159107,486,527,957,1970,159107,0.2467005076142132,0.26751269035532993,0.4857868020304569,6
159108,836,1074,1756,3666,159108,0.22804146208401527,0.29296235679214405,0.4789961811238407,6
159201,360,430,750,1540,159201,0.23376623376623376,0.2792207792207792,0.487012987012987,6
159203,540,633,1516,2689,159203,0.20081814801041278,0.23540349572331723,0.56377835626627,6
159204,399,544,943,1886,159204,0.21155885471898198,0.28844114528101805,0.5,6
159300,241,243,557,1041,159300,0.23150816522574447,0.2334293948126801,0.5350624399615754,6
159404,839,1158,1549,3546,159404,0.23660462492949802,0.32656514382402707,0.4368302312464749,5
159406,469,586,1143,2198,159406,0.21337579617834396,0.26660600545950863,0.5200181983621474,6
159407,676,995,1612,3283,159407,0.20590922936338715,0.30307645446238196,0.4910143161742309,5
159408,524,640,1077,2241,159408,0.23382418563141455,0.285586791610888,0.48058902275769744,6
159410,825,979,1912,3716,159410,0.22201291711517762,0.2634553283100108,0.5145317545748116,6
159411,362,499,893,1754,159411,0.2063854047890536,0.2844925883694413,0.5091220068415051,6
159412,796,925,2020,3741,159412,0.2127773322641005,0.24726009088479017,0.5399625768511094,6
159505,840,1229,1810,3879,159505,0.21655065738592422,0.3168342356277391,0.4666151069863367,5
159506,1047,1372,1738,4157,159506,0.25186432523454416,0.3300457060380082,0.4180899687274477,5
159508,792,1100,1563,3455,159508,0.229232995658466,0.3183791606367583,0.4523878437047757,5
159509,331,451,591,1373,159509,0.24107793153678078,0.32847778587035686,0.4304442825928623,5
159510,37,63,49,149,159510,0.2483221476510067,0.4228187919463087,0.3288590604026846,5
159511,809,1068,1469,3346,159511,0.24178123132098028,0.31918708906156606,0.43903167961745365,5
159512,282,372,559,1213,159512,0.23248145094806266,0.30667765869744434,0.460840890354493,5
159601,648,774,1638,3060,159601,0.21176470588235294,0.2529411764705882,0.5352941176470588,6
159602,496,532,1153,2181,159602,0.22741861531407612,0.24392480513525905,0.5286565795506648,6
160003,198,252,459,909,160003,0.21782178217821782,0.27722772277227725,0.504950495049505,6
160004,190,271,585,1046,160004,0.18164435946462715,0.25908221797323133,0.5592734225621415,6
160005,261,233,589,1083,160005,0.2409972299168975,0.21514312096029548,0.543859649122807,6
161700,454,640,1098,2192,161700,0.2071167883211679,0.291970802919708,0.5009124087591241,6
162100,624,883,1271,2778,162100,0.22462203023758098,0.3178545716342693,0.45752339812814974,5
169701,734,806,2033,3573,169701,0.20542961097117268,0.22558074447243212,0.5689896445563952,6
169703,206,278,476,960,169703,0.21458333333333332,0.28958333333333336,0.49583333333333335,6
169704,685,907,1500,3092,169704,0.22153945666235447,0.29333764553686936,0.4851228978007762,6
169800,698,1033,1069,2800,169800,0.24928571428571428,0.36892857142857144,0.3817857142857143,5
169901,587,822,1167,2576,169901,0.2278726708074534,0.3190993788819876,0.453027950310559,5
169902,392,503,863,1758,169902,0.2229806598407281,0.28612059158134245,0.4908987485779295,6
170000,380,385,732,1497,170000,0.25384101536406145,0.2571810287241149,0.48897795591182364,6
170001,628,720,1300,2648,170001,0.23716012084592145,0.2719033232628399,0.4909365558912387,6
170002,427,511,950,1888,170002,0.22616525423728814,0.2706567796610169,0.503177966101695,6
170101,265,365,426,1056,170101,0.2509469696969697,0.3456439393939394,0.4034090909090909,5
170201,535,704,1212,2451,170201,0.2182782537739698,0.2872297021623827,0.4944920440636475,6
170202,404,482,725,1611,170202,0.25077591558038487,0.29919304779639977,0.4500310366232154,6
180001,455,467,1073,1995,180001,0.22807017543859648,0.23408521303258145,0.537844611528822,6
180300,250,268,499,1017,180300,0.24582104228121926,0.2635201573254671,0.49065880039331367,6
190101,449,430,920,1799,190101,0.24958310172317955,0.23902167871039467,0.5113952195664258,6
190102,244,260,466,970,190102,0.2515463917525773,0.26804123711340205,0.48041237113402063,6
190203,314,339,593,1246,190203,0.2520064205457464,0.27207062600321025,0.47592295345104335,6
190204,566,632,1183,2381,190204,0.2377152456950861,0.26543469130617386,0.49685006299874,6
190301,387,529,817,1733,190301,0.2233121754183497,0.30525100980957875,0.47143681477207156,5
190401,975,1318,1911,4204,190401,0.2319219790675547,0.31351094196003804,0.4545670789724072,5
190402,683,749,1270,2702,190402,0.2527757216876388,0.2772020725388601,0.4700222057735011,6
190403,373,503,770,1646,190403,0.22660996354799515,0.30558930741190765,0.46780072904009723,5
190502,303,319,621,1243,190502,0.24376508447304907,0.25663716814159293,0.499597747385358,6
190503,296,309,648,1253,190503,0.23623304070231443,0.24660814046288906,0.5171588188347965,6
190504,190,217,489,896,190504,0.21205357142857142,0.2421875,0.5457589285714286,6
190601,441,520,989,1950,190601,0.22615384615384615,0.26666666666666666,0.5071794871794871,6
190603,442,519,1115,2076,190603,0.21290944123314065,0.25,0.5370905587668593,6
190604,440,606,1084,2130,190604,0.20657276995305165,0.28450704225352114,0.5089201877934272,6
190704,209,305,519,1033,190704,0.20232333010648595,0.2952565343659245,0.5024201355275896,6
190705,297,473,760,1530,190705,0.19411764705882353,0.30915032679738563,0.49673202614379086,5
190706,446,604,1113,2163,190706,0.2061950993989829,0.2792417938049006,0.5145631067961165,6
190707,418,581,1156,2155,190707,0.19396751740139212,0.2696055684454756,0.5364269141531323,6
190708,211,246,428,885,190708,0.2384180790960452,0.27796610169491526,0.48361581920903957,6
190800,291,372,629,1292,190800,0.22523219814241485,0.28792569659442724,0.4868421052631579,6
200001,323,384,628,1335,200001,0.24194756554307117,0.2876404494382023,0.4704119850187266,6
200002,108,147,258,513,200002,0.21052631578947367,0.28654970760233917,0.5029239766081871,6
200901,118,159,275,552,200901,0.213768115942029,0.28804347826086957,0.49818840579710144,6
200902,554,743,1449,2746,200902,0.20174799708667152,0.2705753823743627,0.5276766205389658,6
201001,574,886,1451,2911,201001,0.19718309859154928,0.3043627619374785,0.49845413947097217,5
201003,324,486,682,1492,201003,0.21715817694369974,0.3257372654155496,0.4571045576407507,5
201004,339,510,709,1558,201004,0.21758664955070603,0.32734274711168165,0.45507060333761234,5
201100,724,1202,958,2884,201100,0.2510402219140083,0.41678224687933424,0.33217753120665744,5
210101,617,665,961,2243,210101,0.27507802050824787,0.2964779313419527,0.42844404814979936,6
210201,425,577,824,1826,210201,0.23274917853231106,0.31599123767798465,0.45125958378970427,5
210301,427,534,888,1849,210301,0.23093564088696591,0.2888047593293672,0.48025959978366684,6
220100,564,675,857,2096,220100,0.26908396946564883,0.3220419847328244,0.4088740458015267,5
220201,393,528,499,1420,220201,0.2767605633802817,0.37183098591549296,0.35140845070422533,5
220300,562,677,658,1897,220300,0.2962572482867686,0.35687928307854505,0.34686346863468637,5
220700,288,369,500,1157,220700,0.24891961970613655,0.31892826274848746,0.43215211754537597,5
220801,439,475,757,1671,220801,0.26271693596648715,0.28426092160383004,0.4530221424296828,6
220901,479,621,854,1954,220901,0.24513817809621288,0.3178096212896622,0.43705220061412486,5
221001,389,489,1138,2016,221001,0.19295634920634921,0.2425595238095238,0.564484126984127,6
221100,437,509,526,1472,221100,0.296875,0.34578804347826086,0.35733695652173914,5
300000,586,795,1045,2426,300000,0.24154987633965375,0.3276999175597692,0.43075020610057707,5
300100,281,361,1115,1757,300100,0.15993170176437108,0.20546385885031304,0.6346044393853159,6
300300,351,424,1054,1829,300300,0.19190814652815746,0.23182066703116458,0.576271186440678,6
300400,434,501,1282,2217,300400,0.19576003608479928,0.2259810554803789,0.5782589084348219,6
300500,382,424,1362,2168,300500,0.17619926199261993,0.19557195571955718,0.6282287822878229,6
300600,471,495,1618,2584,300600,0.18227554179566563,0.19156346749226005,0.6261609907120743,6
300700,406,499,1637,2542,300700,0.15971675845790717,0.19630212431156568,0.6439811172305271,6
300800,305,442,1233,1980,300800,0.15404040404040403,0.22323232323232323,0.6227272727272727,6
300900,565,648,2117,3330,300900,0.16966966966966968,0.1945945945945946,0.6357357357357357,6
301000,340,409,1297,2046,301000,0.16617790811339198,0.19990224828934505,0.6339198435972629,6
301101,510,690,1596,2796,301101,0.18240343347639484,0.24678111587982832,0.5708154506437768,6
301102,409,362,1260,2031,301102,0.20137863121614968,0.17823732151649435,0.620384047267356,6
301200,417,498,1539,2454,301200,0.16992665036674817,0.20293398533007334,0.6271393643031785,6
301300,442,580,1274,2296,301300,0.19250871080139373,0.25261324041811845,0.5548780487804879,6
301400,162,173,643,978,301400,0.1656441717791411,0.1768916155419223,0.6574642126789366,6
301500,203,233,831,1267,301500,0.16022099447513813,0.18389897395422258,0.6558800315706393,6
301600,322,351,1246,1919,301600,0.16779572694111516,0.1829077644606566,0.6492965085982283,6
301700,165,194,697,1056,301700,0.15625,0.18371212121212122,0.6600378787878788,6
301800,467,530,1336,2333,301800,0.20017145306472353,0.2271753107586798,0.5726532361765967,6
301900,172,273,857,1302,301900,0.13210445468509985,0.20967741935483872,0.6582181259600615,6
302000,341,468,1456,2265,302000,0.15055187637969095,0.20662251655629138,0.6428256070640177,6
302101,280,350,1158,1788,302101,0.15659955257270694,0.19574944071588368,0.6476510067114094,6
302102,342,289,1052,1683,302102,0.20320855614973263,0.1717171717171717,0.6250742721330956,6
302200,379,454,1100,1933,302200,0.19606828763579928,0.23486808070356957,0.5690636316606311,6
302300,387,515,1359,2261,302300,0.17116320212295444,0.22777532065457762,0.6010614772224679,6
302400,440,580,1513,2533,302400,0.17370706671930516,0.2289774970390841,0.5973154362416108,6
302501,215,292,745,1252,302501,0.17172523961661343,0.23322683706070288,0.5950479233226837,6
302502,208,277,782,1267,302502,0.16416732438831885,0.21862667719021311,0.6172059984214681,6
302600,233,291,635,1159,302600,0.20103537532355478,0.25107851596203623,0.547886108714409,6
302700,404,504,1223,2131,302700,0.18958235570154858,0.23650868137024872,0.5739089629282027,6
302800,571,677,1765,3013,302800,0.18951211417192168,0.2246929970129439,0.5857948888151344,6
302900,426,405,1264,2095,302900,0.20334128878281624,0.19331742243436753,0.6033412887828162,6
303000,516,636,1515,2667,303000,0.19347581552305962,0.23847019122609675,0.5680539932508436,6
303101,323,395,1037,1755,303101,0.18404558404558405,0.22507122507122507,0.5908831908831909,6
303102,417,452,1255,2124,303102,0.1963276836158192,0.2128060263653484,0.5908662900188324,6
303201,374,447,1124,1945,303201,0.1922879177377892,0.22982005141388176,0.5778920308483291,6
303202,411,505,1114,2030,303202,0.20246305418719213,0.24876847290640394,0.548768472906404,6
303301,364,335,958,1657,303301,0.21967410983705493,0.20217260108630053,0.5781532890766445,6
303302,459,522,1258,2239,303302,0.20500223313979454,0.2331397945511389,0.5618579723090665,6
303400,275,237,793,1305,303400,0.210727969348659,0.18160919540229886,0.6076628352490422,6
303500,492,596,1564,2652,303500,0.18552036199095023,0.22473604826546004,0.5897435897435898,6
303600,707,843,2166,3716,303600,0.1902583423035522,0.2268568353067815,0.5828848223896663,6
303700,658,884,2151,3693,303700,0.17817492553479555,0.23937178445708096,0.5824532900081235,6
303800,530,644,1548,2722,303800,0.1947097722263042,0.23659074210139602,0.5686994856722998,6
303900,455,600,1064,2119,303900,0.2147239263803681,0.2831524303916942,0.5021236432279377,6
304001,270,403,804,1477,304001,0.18280297901150983,0.2728503723764387,0.5443466486120515,6
304002,409,663,1207,2279,304002,0.17946467749012726,0.29091706888986396,0.5296182536200088,6
304100,507,805,974,2286,304100,0.22178477690288714,0.3521434820647419,0.42607174103237094,5
304202,433,697,779,1909,304202,0.22682032477737035,0.3651126244106862,0.40806705081194344,5
304203,762,1346,1059,3167,304203,0.2406062519734765,0.42500789390590465,0.3343858541206189,5
304204,600,1042,802,2444,304204,0.24549918166939444,0.42635024549918166,0.3281505728314239,5
401200,355,569,602,1526,401200,0.23263433813892528,0.372870249017038,0.3944954128440367,5
401300,541,756,890,2187,401300,0.2473708276177412,0.345679012345679,0.4069501600365798,5
404300,327,378,926,1631,404300,0.2004904966278357,0.2317596566523605,0.5677498467198038,6
404400,489,498,1439,2426,404400,0.2015663643858203,0.20527617477328935,0.5931574608408904,6
404500,406,424,1199,2029,404500,0.20009857072449483,0.20896993592902907,0.5909314933464761,6
404600,423,428,1344,2195,404600,0.1927107061503417,0.19498861047835991,0.6123006833712984,6
404700,628,604,1730,2962,404700,0.21201890614449695,0.20391627278865632,0.5840648210668468,6
404800,710,1057,1547,3314,404800,0.21424260712130355,0.3189499094749547,0.4668074834037417,5
404901,597,883,1416,2896,404901,0.206146408839779,0.3049033149171271,0.4889502762430939,5
404902,419,787,1033,2239,404902,0.18713711478338543,0.35149620366234924,0.4613666815542653,5
405000,547,764,1276,2587,405000,0.21144182450715113,0.2953227676845767,0.49323540780827213,6
405100,859,1203,2069,4131,405100,0.20793996610990076,0.29121278140885987,0.5008472524812394,6
405200,611,952,1487,3050,405200,0.200327868852459,0.3121311475409836,0.4875409836065574,5
405301,358,442,953,1753,405301,0.20422133485453509,0.25213918996006845,0.5436394751853965,6
405302,461,499,1281,2241,405302,0.20571173583221777,0.22266845158411425,0.571619812583668,6
405400,838,993,2114,3945,405400,0.21242078580481621,0.25171102661596956,0.5358681875792142,6
405500,568,592,1655,2815,405500,0.20177619893428064,0.2103019538188277,0.5879218472468917,6
405600,472,528,1232,2232,405600,0.2114695340501792,0.23655913978494625,0.5519713261648745,6
405700,454,547,1445,2446,405700,0.1856091578086672,0.22363041700735894,0.5907604251839739,6
405800,397,481,1283,2161,405800,0.18371124479407683,0.2225821378991208,0.5937066173068024,6
405900,577,652,1421,2650,405900,0.2177358490566038,0.2460377358490566,0.5362264150943397,6
406001,482,643,1320,2445,406001,0.19713701431492842,0.26298568507157466,0.5398773006134969,6
406002,346,383,834,1563,406002,0.22136916186820219,0.24504158669225848,0.5335892514395394,6
406100,373,398,900,1671,406100,0.2232196289646918,0.2381807301017355,0.5385996409335727,6
406201,362,514,864,1740,406201,0.20804597701149424,0.29540229885057473,0.496551724137931,6
406202,644,891,1627,3162,406202,0.2036685641998735,0.28178368121442127,0.5145477545857052,6
406300,351,393,1096,1840,406300,0.1907608695652174,0.21358695652173912,0.5956521739130435,6
406400,504,536,1858,2898,406400,0.17391304347826086,0.1849551414768806,0.6411318150448585,6
406501,551,565,1935,3051,406501,0.1805965257292691,0.18518518518518517,0.6342182890855457,6
406600,345,363,1291,1999,406600,0.17258629314657328,0.18159079539769885,0.6458229114557279,6
406701,354,542,525,1421,406701,0.24912033779028853,0.38142153413089375,0.3694581280788177,5
406702,567,731,769,2067,406702,0.274310595065312,0.3536526366715046,0.3720367682631834,5
406801,524,842,576,1942,406801,0.2698249227600412,0.43357363542739447,0.29660144181256437,4
406802,557,913,637,2107,406802,0.26435690555291885,0.43331751305173233,0.3023255813953488,5
406900,835,1246,1045,3126,406900,0.26711452335252717,0.39859245041586694,0.3342930262316059,5
407000,762,1201,1032,2995,407000,0.254424040066778,0.4010016694490818,0.34457429048414023,5
407101,568,866,856,2290,407101,0.2480349344978166,0.37816593886462885,0.3737991266375546,5
407102,664,993,967,2624,407102,0.2530487804878049,0.3784298780487805,0.36852134146341464,5
407201,477,833,594,1904,407201,0.2505252100840336,0.4375,0.3119747899159664,5
407203,356,578,569,1503,407203,0.2368596141051231,0.38456420492348636,0.37857618097139056,5
407204,316,452,494,1262,407204,0.25039619651347067,0.358161648177496,0.39144215530903326,5
407301,542,605,1036,2183,407301,0.24828218048557033,0.277141548327989,0.4745762711864407,6
407302,668,912,940,2520,407302,0.2650793650793651,0.3619047619047619,0.373015873015873,5
407401,687,1192,953,2832,407401,0.24258474576271186,0.4209039548022599,0.3365112994350282,5
407402,397,703,652,1752,407402,0.22659817351598174,0.4012557077625571,0.3721461187214612,5
407501,588,1009,861,2458,407501,0.23921887713588283,0.41049633848657446,0.35028478437754274,5
407502,687,1060,966,2713,407502,0.2532252119424991,0.39071138960560264,0.35606339845189827,5
407600,583,708,1545,2836,407600,0.20557122708039494,0.24964739069111425,0.5447813822284908,6
407700,502,610,1496,2608,407700,0.19248466257668712,0.2338957055214724,0.5736196319018405,6
407801,573,689,1583,2845,407801,0.2014059753954306,0.2421792618629174,0.556414762741652,6
407802,153,190,444,787,407802,0.19440914866581957,0.241423125794155,0.5641677255400254,6
407900,541,591,1417,2549,407900,0.21224009415457043,0.2318556296586897,0.5559042761867399,6
408000,758,774,1908,3440,408000,0.22034883720930232,0.225,0.5546511627906977,6
408100,792,870,2058,3720,408100,0.2129032258064516,0.23387096774193547,0.5532258064516129,6
408200,780,885,1967,3632,408200,0.21475770925110133,0.24366740088105726,0.5415748898678414,6
408300,788,958,2080,3826,408300,0.20595922634605332,0.25039205436487194,0.5436487192890748,6
408400,430,405,1304,2139,408400,0.201028517999065,0.18934081346423562,0.6096306685366993,6
408500,688,697,1901,3286,408500,0.209373097991479,0.21211199026171637,0.5785149117468046,6
408600,551,595,1309,2455,408600,0.2244399185336049,0.24236252545824846,0.5331975560081467,6
408700,507,700,1388,2595,408700,0.19537572254335261,0.2697495183044316,0.5348747591522158,6
408800,812,883,2008,3703,408800,0.21928166351606806,0.23845530650823657,0.5422630299756954,6
408900,675,810,1688,3173,408900,0.21273242987708793,0.2552789158525055,0.5319886542704065,6
409000,673,796,1679,3148,409000,0.21378653113087676,0.25285895806861497,0.5333545108005082,6
409100,622,734,1654,3010,409100,0.20664451827242525,0.24385382059800664,0.5495016611295681,6
409200,773,849,1832,3454,409200,0.22379849449913145,0.24580196873190505,0.5303995367689636,6
409300,528,598,1296,2422,409300,0.2180016515276631,0.24690338563170933,0.5350949628406276,6
409400,565,558,1231,2354,409400,0.24001699235344096,0.23704333050127444,0.5229396771452847,6
409500,511,479,1216,2206,409500,0.23164097914777879,0.2171350861287398,0.5512239347234814,6
409600,533,621,1528,2682,409600,0.19873228933631618,0.23154362416107382,0.56972408650261,6
409700,462,498,1268,2228,409700,0.2073608617594255,0.22351885098743268,0.5691202872531418,6
409800,558,790,1487,2835,409800,0.19682539682539682,0.2786596119929453,0.5245149911816579,6
409900,791,1021,2099,3911,409900,0.20225006392227052,0.26105855279979545,0.5366913832779341,6
410000,667,773,1565,3005,410000,0.22196339434276208,0.2572379367720466,0.5207986688851913,6
410100,645,698,1723,3066,410100,0.21037181996086105,0.22765818656229614,0.5619699934768428,6
410200,405,443,1111,1959,410200,0.20673813169984687,0.22613578356304237,0.5671260847371108,6
410300,653,935,1640,3228,410300,0.2022924411400248,0.2896530359355638,0.5080545229244114,6
410400,529,808,1381,2718,410400,0.19462840323767477,0.2972774098601913,0.5080941869021339,6
410500,744,959,1714,3417,410500,0.2177348551360843,0.2806555458004097,0.501609599063506,6
410600,693,899,1913,3505,410600,0.1977175463623395,0.256490727532097,0.5457917261055635,6
410700,681,869,1686,3236,410700,0.21044499381953027,0.2685414091470952,0.5210135970333746,6
410800,527,627,1451,2605,410800,0.20230326295585413,0.24069097888675625,0.5570057581573896,6
410900,523,692,1444,2659,410900,0.1966904851447913,0.26024821361414063,0.5430613012410681,6
411000,549,705,1126,2380,411000,0.23067226890756304,0.296218487394958,0.473109243697479,6
411100,425,664,836,1925,411100,0.22077922077922077,0.34493506493506493,0.4342857142857143,5
411200,528,667,1528,2723,411200,0.1939037825927286,0.24495042232831435,0.561145795078957,6
411301,319,371,961,1651,411301,0.19321623258631132,0.2247122955784373,0.5820714718352513,6
411302,569,583,1623,2775,411302,0.20504504504504503,0.21009009009009008,0.5848648648648649,6
411400,514,599,1492,2605,411400,0.19731285988483685,0.22994241842610363,0.5727447216890595,6
411500,250,277,839,1366,411500,0.18301610541727673,0.2027818448023426,0.6142020497803806,6
411600,483,553,1418,2454,411600,0.19682151589242053,0.22534637326813367,0.5778321108394459,6
411700,658,784,1723,3165,411700,0.20789889415481833,0.24770932069510268,0.544391785150079,6
411800,724,752,1912,3388,411800,0.21369539551357733,0.22195985832349469,0.564344746162928,6
411901,324,416,939,1679,411901,0.19297200714711138,0.24776652769505658,0.559261465157832,6
411902,366,441,1066,1873,411902,0.19540843566470903,0.23545114789108382,0.5691404164442072,6
412000,660,736,1748,3144,412000,0.2099236641221374,0.2340966921119593,0.5559796437659033,6
412100,638,683,1796,3117,412100,0.20468399101700352,0.2191209496310555,0.5761950593519409,6
412200,518,557,1566,2641,412200,0.19613782658084059,0.21090496024233246,0.5929572131768269,6
412301,325,367,1026,1718,412301,0.18917345750873107,0.21362048894062863,0.5972060535506403,6
412302,428,458,1026,1912,412302,0.22384937238493724,0.2395397489539749,0.5366108786610879,6
412400,523,655,1499,2677,412400,0.19536794919686215,0.24467687710123273,0.5599551737019051,6
412500,403,371,1217,1991,412500,0.2024108488196886,0.18633852335509793,0.6112506278252134,6
412600,289,299,1098,1686,412600,0.17141162514827996,0.17734282325029657,0.6512455516014235,6
412700,333,317,1141,1791,412700,0.18592964824120603,0.17699609156895588,0.637074260189838,6
412800,393,415,1046,1854,412800,0.21197411003236247,0.2238403451995685,0.564185544768069,6
412900,631,906,1632,3169,412900,0.1991164405175134,0.2858946039760177,0.514988955506469,6
413001,477,495,1250,2222,413001,0.21467146714671467,0.22277227722772278,0.5625562556255626,6
413002,452,447,1108,2007,413002,0.22521175884404585,0.2227204783258595,0.5520677628300946,6
413100,515,583,1492,2590,413100,0.19884169884169883,0.22509652509652509,0.5760617760617761,6
413200,722,692,1915,3329,413200,0.21688194653048964,0.2078702313006909,0.5752478221688194,6
413300,687,819,2096,3602,413300,0.19072737368128817,0.22737368128817323,0.5818989450305386,6
413400,506,640,1639,2785,413400,0.18168761220825852,0.22980251346499103,0.5885098743267505,6
413500,737,978,2151,3866,413500,0.19063631660631145,0.2529746508018624,0.5563890325918261,6
413600,614,733,1585,2932,413600,0.20941336971350613,0.25,0.5405866302864939,6
413700,520,690,1448,2658,413700,0.19563581640331076,0.2595936794582393,0.54477050413845,6
413803,435,531,1212,2178,413803,0.19972451790633608,0.24380165289256198,0.5564738292011019,6
413804,467,526,1137,2130,413804,0.2192488262910798,0.24694835680751173,0.5338028169014084,6
413900,731,1307,1218,3256,413900,0.2245085995085995,0.4014127764127764,0.3740786240786241,5
414001,468,661,747,1876,414001,0.24946695095948826,0.3523454157782516,0.39818763326226014,5
414002,590,893,767,2250,414002,0.26222222222222225,0.3968888888888889,0.3408888888888889,5
414100,677,1066,1201,2944,414100,0.22995923913043478,0.36209239130434784,0.4079483695652174,5
414201,575,943,847,2365,414201,0.24312896405919662,0.39873150105708244,0.3581395348837209,5
414202,465,848,693,2006,414202,0.23180458624127617,0.42273180458624127,0.34546360917248253,5
414301,406,600,632,1638,414301,0.24786324786324787,0.3663003663003663,0.38583638583638585,5
414303,530,785,897,2212,414303,0.23960216998191683,0.35488245931283907,0.4055153707052441,5
414304,466,806,562,1834,414304,0.25408942202835333,0.4394765539803708,0.3064340239912759,5
414400,604,901,846,2351,414400,0.2569119523606976,0.38324117396852403,0.3598468736707784,5
414501,629,782,1190,2601,414501,0.24183006535947713,0.3006535947712418,0.45751633986928103,5
414502,514,689,1064,2267,414502,0.2267313630348478,0.3039258932509925,0.4693427437141597,5
414600,419,408,1167,1994,414600,0.21013039117352056,0.2046138415245737,0.5852557673019058,6
414700,489,479,1492,2460,414700,0.19878048780487806,0.19471544715447153,0.6065040650406504,6
414800,679,776,2054,3509,414800,0.19350242234254775,0.22114562553434028,0.585351952123112,6
414900,900,808,2311,4019,414900,0.22393630256282657,0.20104503607862653,0.575018661358547,6
415000,662,663,1818,3143,415000,0.21062678969137766,0.21094495704740693,0.5784282532612154,6
415101,314,280,921,1515,415101,0.20726072607260726,0.1848184818481848,0.6079207920792079,6
415102,453,508,1673,2634,415102,0.17198177676537585,0.19286256643887623,0.6351556567957479,6
415201,368,380,1102,1850,415201,0.1989189189189189,0.20540540540540542,0.5956756756756757,6
415202,416,414,1315,2145,415202,0.19393939393939394,0.193006993006993,0.6130536130536131,6
415300,739,671,1945,3355,415300,0.2202682563338301,0.2,0.5797317436661699,6
415401,586,565,1563,2714,415401,0.2159174649963154,0.2081798084008843,0.5759027266028003,6
415402,420,470,1432,2322,415402,0.18087855297157623,0.20241171403962102,0.6167097329888027,6
415500,376,342,855,1573,415500,0.23903369357914814,0.21741894469167197,0.54354736172918,6
415600,565,593,1833,2991,415600,0.18890003343363423,0.19826145101972584,0.6128385155466399,6
415700,642,715,1902,3259,415700,0.1969929426204357,0.21939245167229213,0.5836146057072722,6
415802,743,729,2299,3771,415802,0.19702996552638558,0.19331742243436753,0.6096526120392469,6
416000,414,461,1266,2141,416000,0.1933675852405418,0.21531994395142456,0.5913124708080336,6
416100,731,803,1981,3515,416100,0.20796586059743954,0.22844950213371265,0.5635846372688478,6
416201,404,454,1054,1912,416201,0.2112970711297071,0.23744769874476987,0.551255230125523,6
416202,534,621,1199,2354,416202,0.2268479184367035,0.26380628717077315,0.5093457943925234,6
416300,299,360,979,1638,416300,0.18253968253968253,0.21978021978021978,0.5976800976800977,6
416401,346,384,1055,1785,416401,0.1938375350140056,0.21512605042016808,0.5910364145658263,6
416402,283,313,810,1406,416402,0.20128022759601708,0.22261735419630158,0.5761024182076814,6
416500,695,852,1381,2928,416500,0.23736338797814208,0.29098360655737704,0.47165300546448086,6
416600,429,528,1424,2381,416600,0.18017639647207057,0.22175556488870224,0.5980680386392272,6
416701,396,444,1084,1924,416701,0.20582120582120583,0.23076923076923078,0.5634095634095634,6
416702,337,383,1173,1893,416702,0.1780243000528262,0.202324352879028,0.6196513470681458,6
416801,238,239,627,1104,416801,0.21557971014492755,0.2164855072463768,0.5679347826086957,6
416802,350,392,1086,1828,416802,0.19146608315098468,0.21444201312910285,0.5940919037199125,6
416900,402,398,1185,1985,416900,0.20251889168765744,0.2005037783375315,0.5969773299748111,6
490100,345,495,374,1214,490100,0.2841845140032949,0.40774299835255357,0.30807248764415157,5
490200,383,443,610,1436,490200,0.2667130919220056,0.3084958217270195,0.42479108635097496,5
490300,532,664,646,1842,490300,0.2888165038002172,0.36047774158523344,0.3507057546145494,5
490400,302,369,540,1211,490400,0.24938067712634188,0.30470685383980184,0.44591246903385634,5
490500,359,428,496,1283,490500,0.2798129384255651,0.33359314107560406,0.38659392049883085,5
490600,338,582,600,1520,490600,0.22236842105263158,0.3828947368421053,0.39473684210526316,5
490700,560,782,743,2085,490700,0.2685851318944844,0.3750599520383693,0.3563549160671463,5
490800,341,323,603,1267,490800,0.2691397000789266,0.2549329123914759,0.47592738752959746,6
490900,374,401,540,1315,490900,0.2844106463878327,0.30494296577946767,0.41064638783269963,5
491000,496,653,727,1876,491000,0.26439232409381663,0.34808102345415776,0.3875266524520256,5
491100,62,55,78,195,491100,0.31794871794871793,0.28205128205128205,0.4,2
491200,46,63,75,184,491200,0.25,0.3423913043478261,0.4076086956521739,5
491300,332,581,570,1483,491300,0.22387053270397841,0.39177343223196226,0.38435603506405935,5
491400,363,575,484,1422,491400,0.2552742616033755,0.40436005625879046,0.340365682137834,5
491500,338,522,496,1356,491500,0.24926253687315633,0.38495575221238937,0.36578171091445427,5
491600,257,423,245,925,491600,0.27783783783783783,0.4572972972972973,0.2648648648648649,4
491700,370,586,578,1534,491700,0.24119947848761408,0.3820078226857888,0.3767926988265971,5
491800,347,465,440,1252,491800,0.2771565495207668,0.37140575079872207,0.3514376996805112,5
491900,54,47,53,154,491900,0.35064935064935066,0.3051948051948052,0.34415584415584416,3
492000,572,592,782,1946,492000,0.29393627954779034,0.30421377183967113,0.40184994861253853,5
492100,366,405,480,1251,492100,0.29256594724220625,0.3237410071942446,0.38369304556354916,5
492300,533,745,840,2118,492300,0.2516525023607177,0.35174693106704435,0.39660056657223797,5
492400,234,366,308,908,492400,0.2577092511013216,0.40308370044052866,0.3392070484581498,5
492500,218,261,246,725,492500,0.3006896551724138,0.36,0.3393103448275862,3
492600,526,686,716,1928,492600,0.27282157676348545,0.3558091286307054,0.37136929460580914,5
492700,503,652,595,1750,492700,0.2874285714285714,0.37257142857142855,0.34,5
492800,220,303,305,828,492800,0.26570048309178745,0.36594202898550726,0.36835748792270534,5
492900,180,243,210,633,492900,0.2843601895734597,0.38388625592417064,0.33175355450236965,5
517000,299,391,964,1654,517000,0.1807738814993954,0.23639661426844014,0.5828295042321644,6
517101,597,746,1309,2652,517101,0.2251131221719457,0.2812971342383107,0.4935897435897436,6
517102,231,317,685,1233,517102,0.1873479318734793,0.2570965125709651,0.5555555555555556,6
517200,815,1123,1667,3605,517200,0.2260748959778086,0.3115117891816921,0.4624133148404993,5
517301,287,384,754,1425,517301,0.20140350877192983,0.2694736842105263,0.5291228070175439,6
517302,505,609,1212,2326,517302,0.2171109200343938,0.261822871883061,0.5210662080825451,6
517400,503,475,1345,2323,517400,0.21653034868704263,0.20447696943607405,0.5789926818768834,6
517500,339,363,1083,1785,517500,0.1899159663865546,0.20336134453781513,0.6067226890756302,6
517600,406,472,1309,2187,517600,0.18564243255601282,0.21582075903063558,0.5985368084133517,6
517701,528,628,1921,3077,517701,0.1715957101072473,0.2040948976275593,0.6243093922651933,6
517705,194,215,640,1049,517705,0.18493803622497618,0.2049571020019066,0.6101048617731173,6
517801,237,309,946,1492,517801,0.15884718498659517,0.20710455764075067,0.6340482573726541,6
517802,332,382,961,1675,517802,0.1982089552238806,0.22805970149253732,0.5737313432835821,6
517901,515,513,1403,2431,517901,0.21184697655285892,0.21102426984779926,0.5771287535993418,6
517902,310,319,822,1451,517902,0.2136457615437629,0.21984838042729152,0.5665058580289456,6
518000,577,685,1823,3085,518000,0.18703403565640195,0.22204213938411668,0.5909238249594814,6
518100,262,307,880,1449,518100,0.1808143547273982,0.21187025534851622,0.6073153899240856,6
518201,317,366,1204,1887,518201,0.1679915209326974,0.19395866454689983,0.6380498145204028,6
518203,296,333,1032,1661,518203,0.1782059000602047,0.20048163756773027,0.621312462372065,6
518204,366,362,1266,1994,518204,0.18355065195586762,0.1815446339017051,0.6349047141424273,6
518300,490,542,1567,2599,518300,0.18853405155829164,0.2085417468257022,0.6029242016160061,6
518400,401,415,1163,1979,518400,0.2026275896917635,0.20970186963112683,0.5876705406771097,6
518501,536,594,1716,2846,518501,0.18833450456781448,0.20871398453970486,0.6029515108924807,6
518502,302,309,906,1517,518502,0.1990771259063942,0.20369149637442321,0.5972313777191826,6
518600,331,356,1069,1756,518600,0.18849658314350798,0.20273348519362186,0.6087699316628702,6
518700,465,513,1504,2482,518700,0.18734891216760677,0.20668815471394036,0.6059629331184528,6
518800,308,339,954,1601,518800,0.19237976264834478,0.21174266083697688,0.5958775765146783,6
518900,894,994,1925,3813,518900,0.23446105428796224,0.26068712300026226,0.5048518227117755,6
519000,705,854,1838,3397,519000,0.2075360612304975,0.25139829261112745,0.541065646158375,6
519100,665,808,1766,3239,519100,0.20531028095091078,0.2494597097869713,0.545230009262118,6
519200,763,743,1783,3289,519200,0.23198540589844938,0.22590453025235635,0.5421100638491942,6
519300,752,939,1653,3344,519300,0.22488038277511962,0.28080143540669855,0.4943181818181818,6
519400,505,587,1294,2386,519400,0.21165129924559933,0.2460184409052808,0.5423302598491199,6
519500,578,718,1629,2925,519500,0.19760683760683762,0.24547008547008548,0.556923076923077,6
519601,410,527,1349,2286,519601,0.17935258092738407,0.23053368328958881,0.5901137357830272,6
519602,246,241,643,1130,519602,0.2176991150442478,0.21327433628318584,0.5690265486725664,6
519702,518,548,1574,2640,519702,0.1962121212121212,0.20757575757575758,0.5962121212121212,6
519703,357,378,1051,1786,519703,0.19988801791713326,0.2116461366181411,0.5884658454647257,6
519704,323,333,921,1577,519704,0.20481927710843373,0.21116043119847813,0.5840202916930881,6
519801,264,245,747,1256,519801,0.21019108280254778,0.19506369426751594,0.5947452229299363,6
519802,559,489,1505,2553,519802,0.21895808852330592,0.19153936545240893,0.5895025460242852,6
519900,564,598,1652,2814,519900,0.20042643923240938,0.2125088841506752,0.5870646766169154,6
520001,806,802,1919,3527,520001,0.2285228239296853,0.22738871562234195,0.5440884604479728,6
520002,562,565,1342,2469,520002,0.2276225192385581,0.2288375860672337,0.5435398946942082,6
520100,569,589,1631,2789,520100,0.20401577626389386,0.2111868053065615,0.5847974184295447,6
520200,358,414,997,1769,520200,0.20237422272470323,0.23403052572074617,0.5635952515545506,6
520300,685,731,1739,3155,520300,0.21711568938193343,0.23169572107765452,0.551188589540412,6
520401,500,539,1272,2311,520401,0.2163565556036348,0.2332323669407183,0.5504110774556469,6
520402,509,575,1377,2461,520402,0.20682649329540836,0.2336448598130841,0.5595286468915075,6
520501,423,546,1193,2162,520501,0.1956521739130435,0.25254394079555964,0.5518038852913969,6
520502,638,643,1763,3044,520502,0.20959264126149804,0.21123521681997373,0.5791721419185283,6
520600,737,804,1797,3338,520600,0.2207908927501498,0.2408627920910725,0.5383463151587777,6
520700,535,576,1520,2631,520700,0.20334473584188523,0.21892816419612315,0.5777270999619917,6
520800,496,486,1309,2291,520800,0.21649934526407683,0.21213443910955915,0.571366215626364,6
520900,624,588,1363,2575,520900,0.24233009708737865,0.2283495145631068,0.5293203883495146,6
521000,496,574,1544,2614,521000,0.18974751338944146,0.2195868400918133,0.5906656465187452,6
521100,547,535,1364,2446,521100,0.22363041700735894,0.2187244480784955,0.5576451349141456,6
521200,368,357,964,1689,521200,0.21788040260509178,0.2113676731793961,0.5707519242155121,6
521301,296,280,762,1338,521301,0.22122571001494767,0.20926756352765322,0.5695067264573991,6
521302,632,666,1694,2992,521302,0.21122994652406418,0.22259358288770054,0.5661764705882353,6
521400,637,689,2042,3368,521400,0.18913301662707838,0.20457244655581946,0.6062945368171021,6
521500,524,548,1571,2643,521500,0.19825955353764663,0.20734014377601212,0.5944003026863413,6
521601,450,501,1403,2354,521601,0.1911639762107052,0.21282922684791844,0.5960067969413764,6
521602,343,359,1064,1766,521602,0.1942242355605889,0.20328425821064552,0.6024915062287656,6
521700,561,523,1497,2581,521700,0.2173576133281674,0.2026346377373111,0.5800077489345214,6
521801,367,425,1137,1929,521801,0.1902540176257128,0.22032141005702435,0.5894245723172629,6
521802,454,436,1278,2168,521802,0.20940959409594095,0.2011070110701107,0.5894833948339483,6
521902,488,437,1342,2267,521902,0.2152624614027349,0.19276576973974416,0.591971768857521,6
522000,841,1174,2034,4049,522000,0.20770560632254878,0.28994813534205977,0.5023462583353915,6
522700,496,537,1609,2642,522700,0.18773656320968962,0.2032551097653293,0.6090083270249811,6
590100,450,664,760,1874,590100,0.240128068303095,0.35432230522945574,0.4055496264674493,5
590201,263,434,387,1084,590201,0.24261992619926198,0.4003690036900369,0.3570110701107011,5
590202,410,589,846,1845,590202,0.2222222222222222,0.3192411924119241,0.4585365853658537,5
590300,329,678,548,1555,590300,0.21157556270096464,0.4360128617363344,0.352411575562701,5
590400,438,890,873,2201,590400,0.19900045433893684,0.4043616537937301,0.396637891867333,5
590500,312,480,452,1244,590500,0.2508038585209003,0.3858520900321543,0.3633440514469453,5
590600,180,346,276,802,590600,0.22443890274314215,0.4314214463840399,0.34413965087281795,5
590700,386,603,544,1533,590700,0.2517938682322244,0.3933463796477495,0.3548597521200261,5
590800,515,808,909,2232,590800,0.2307347670250896,0.36200716845878134,0.40725806451612906,5
590900,269,417,374,1060,590900,0.2537735849056604,0.39339622641509436,0.35283018867924526,5
591000,352,373,491,1216,591000,0.2894736842105263,0.3067434210526316,0.4037828947368421,5
591100,379,440,341,1160,591100,0.3267241379310345,0.3793103448275862,0.2939655172413793,1
591200,191,188,292,671,591200,0.2846497764530551,0.28017883755588674,0.43517138599105815,6
591300,81,108,140,329,591300,0.24620060790273557,0.3282674772036474,0.425531914893617,5
591400,549,911,811,2271,591400,0.24174372523117568,0.401144870101277,0.3571114046675473,5
591500,335,561,602,1498,591500,0.22363150867823764,0.37449933244325767,0.40186915887850466,5
591600,397,636,709,1742,591600,0.22789896670493687,0.365097588978186,0.4070034443168771,5
610000,112,104,196,412,610000,0.27184466019417475,0.2524271844660194,0.47572815533980584,6
640001,18,13,10,41,640001,0.43902439024390244,0.3170731707317073,0.24390243902439024,1
640002,82,81,165,328,640002,0.25,0.24695121951219512,0.5030487804878049,6
740100,465,622,619,1706,740100,0.27256740914419697,0.3645955451348183,0.36283704572098474,5
740200,512,733,715,1960,740200,0.2612244897959184,0.3739795918367347,0.3647959183673469,5
740300,61,68,76,205,740300,0.2975609756097561,0.33170731707317075,0.37073170731707317,5
740400,521,793,684,1998,740400,0.26076076076076077,0.3968968968968969,0.34234234234234234,5
740500,342,455,423,1220,740500,0.28032786885245903,0.3729508196721312,0.34672131147540985,5
740600,312,345,439,1096,740600,0.2846715328467153,0.3147810218978102,0.4005474452554745,5
740700,452,593,583,1628,740700,0.27764127764127766,0.3642506142506142,0.3581081081081081,5
740800,326,365,406,1097,740800,0.29717411121239745,0.33272561531449407,0.3701002734731085,5
940000,758,1337,1293,3388,940000,0.22373081463990555,0.39462809917355374,0.38164108618654075,5
940001,138,206,143,487,940001,0.28336755646817247,0.42299794661190965,0.2936344969199179,4
940100,768,1210,1134,3112,940100,0.2467866323907455,0.38881748071979433,0.3643958868894602,5
940101,309,554,337,1200,940101,0.2575,0.46166666666666667,0.2808333333333333,4
940102,544,924,758,2226,940102,0.24438454627133874,0.41509433962264153,0.34052111410601976,5
940103,408,573,704,1685,940103,0.24213649851632046,0.3400593471810089,0.41780415430267065,5
940200,1019,1586,1496,4101,940200,0.24847598146793465,0.3867349426969032,0.3647890758351622,5
940300,1292,2162,1518,4972,940300,0.2598551890587289,0.4348350764279968,0.3053097345132743,5
940401,765,1123,1473,3361,940401,0.2276108301100863,0.33412674799166914,0.43826242189824455,5
940403,593,745,1039,2377,940403,0.2494741270509045,0.3134202776609171,0.4371055952881784,5
940600,771,1088,1199,3058,940600,0.25212557226945714,0.35578809679529105,0.3920863309352518,5
940700,423,516,725,1664,940700,0.2542067307692308,0.31009615384615385,0.43569711538461536,5
950100,3621,4657,5594,13872,950100,0.2610294117647059,0.3357122260668973,0.4032583621683968,5
950200,2757,3855,4145,10757,950200,0.2562982244120108,0.3583712931114623,0.3853304824765269,5
950300,3770,5266,5777,14813,950300,0.2545061770066833,0.3554985485722001,0.3899952744211166,5
950400,3635,5070,4926,13631,950400,0.2666715574792752,0.3719462988775585,0.3613821436431663,5
950500,2739,3660,3939,10338,950500,0.2649448636099826,0.3540336622170633,0.3810214741729541,5
950501,382,444,403,1229,950501,0.31082180634662326,0.36126932465419037,0.3279088689991863,3
950502,270,338,371,979,950502,0.27579162410623087,0.3452502553626149,0.37895812053115424,5
950600,1818,2472,2671,6961,950600,0.26116937221663555,0.35512139060479814,0.3837092371785663,5
950700,2301,3146,2909,8356,950700,0.2753709909047391,0.3764959310674964,0.3481330780277645,5
950800,1929,2343,2396,6668,950800,0.28929214157168565,0.35137972405518897,0.3593281343731254,5
950900,2032,2572,2505,7109,950900,0.28583485722323815,0.3617949078632719,0.35237023491348995,5
951000,1911,2474,2530,6915,951000,0.27635574837310195,0.35777295733911785,0.3658712942877802,5
951100,1735,2516,3094,7345,951100,0.236215112321307,0.34254594962559565,0.42123893805309737,5
951200,2518,3475,4271,10264,951200,0.24532346063912705,0.33856196414653156,0.41611457521434136,5
951300,1771,2350,2961,7082,951300,0.25007060152499294,0.3318271674668173,0.4181022310081898,5
951400,1102,1422,1710,4234,951400,0.2602739726027397,0.3358526216343883,0.403873405762872,5
951500,591,782,1038,2411,951500,0.24512650352550808,0.32434674408958936,0.4305267523849025,5
951600,598,882,980,2460,951600,0.24308943089430896,0.35853658536585364,0.3983739837398374,5
951700,948,1419,1507,3874,951700,0.2447083118224058,0.36628807434176563,0.3890036138358286,5
951800,991,1468,965,3424,951800,0.28942757009345793,0.4287383177570093,0.2818341121495327,4
951900,536,760,783,2079,951900,0.25781625781625783,0.3655603655603656,0.37662337662337664,5
952000,580,676,669,1925,952000,0.3012987012987013,0.3511688311688312,0.3475324675324675,3
952100,647,873,815,2335,952100,0.27708779443254816,0.37387580299785866,0.3490364025695932,5
952200,546,758,1000,2304,952200,0.23697916666666666,0.3289930555555556,0.4340277777777778,5
952300,375,551,611,1537,952300,0.24398178269355889,0.3584905660377358,0.39752765126870526,5
952400,511,663,781,1955,952400,0.26138107416879797,0.3391304347826087,0.39948849104859335,5
952500,550,707,967,2224,952500,0.24730215827338128,0.31789568345323743,0.4348021582733813,5
952600,505,617,1008,2130,952600,0.23708920187793428,0.2896713615023474,0.4732394366197183,6
952700,343,388,530,1261,952700,0.2720063441712926,0.3076923076923077,0.4203013481363997,5
952800,331,445,648,1424,952800,0.2324438202247191,0.3125,0.4550561797752809,5
952900,521,641,993,2155,952900,0.2417633410672854,0.2974477958236659,0.4607888631090487,6
953000,178,217,307,702,953000,0.2535612535612536,0.3091168091168091,0.4373219373219373,5
953300,508,570,949,2027,953300,0.2506166748889985,0.2812037493833251,0.4681795757276764,6
953400,506,556,770,1832,953400,0.2762008733624454,0.3034934497816594,0.4203056768558952,5
953500,376,372,570,1318,953500,0.2852807283763278,0.2822458270106222,0.4324734446130501,6
953600,620,751,1262,2633,953600,0.2354728446638815,0.2852259779718952,0.47930117736422334,6
953700,637,712,1231,2580,953700,0.24689922480620155,0.27596899224806204,0.47713178294573644,6
953800,387,468,721,1576,953800,0.24555837563451777,0.2969543147208122,0.45748730964467005,6
953900,584,606,992,2182,953900,0.2676443629697525,0.2777268560953254,0.4546287809349221,6
954000,590,715,1046,2351,954000,0.25095703955763504,0.3041259038706933,0.44491705657167163,5
954100,506,667,956,2129,954100,0.23767026773132927,0.3132926256458431,0.44903710662282764,5
954200,621,702,1209,2532,954200,0.245260663507109,0.2772511848341232,0.4774881516587678,6
954400,729,857,1484,3070,954400,0.23745928338762215,0.2791530944625407,0.48338762214983716,6
954500,328,391,529,1248,954500,0.26282051282051283,0.31330128205128205,0.4238782051282051,5
954600,152,201,258,611,954600,0.24877250409165302,0.32896890343698854,0.42225859247135844,5
954700,179,178,268,625,954700,0.2864,0.2848,0.4288,6
954800,615,683,642,1940,954800,0.3170103092783505,0.3520618556701031,0.3309278350515464,3
954900,200,252,291,743,954900,0.2691790040376851,0.3391655450874832,0.3916554508748318,5
955000,512,650,845,2007,955000,0.255107125062282,0.3238664673642252,0.4210264075734928,5
955300,286,272,294,852,955300,0.33568075117370894,0.3192488262910798,0.34507042253521125,3
955400,437,491,832,1760,955400,0.24829545454545454,0.27897727272727274,0.4727272727272727,6
960100,744,1262,968,2974,960100,0.25016812373907193,0.42434431741761935,0.32548755884330866,5
960200,1086,1434,1224,3744,960200,0.2900641025641026,0.38301282051282054,0.3269230769230769,5
960300,1081,1390,1445,3916,960300,0.276046986721144,0.35495403472931564,0.36899897854954034,5
960400,903,1141,1115,3159,960400,0.2858499525166192,0.36119025007913896,0.3529597974042418,5
960498,359,360,411,1130,960498,0.3176991150442478,0.3185840707964602,0.363716814159292,3
960500,754,1031,948,2733,960500,0.27588730332967437,0.37724112696670326,0.3468715697036224,5
960598,660,938,762,2360,960598,0.2796610169491525,0.3974576271186441,0.3228813559322034,5
960600,866,1139,1094,3099,960600,0.2794449822523395,0.3675379154565989,0.35301710229106165,5
960700,500,733,702,1935,960700,0.25839793281653745,0.3788113695090439,0.3627906976744186,5
960702,398,406,413,1217,960702,0.32703368940016436,0.33360723089564503,0.33935907970419066,3
960800,979,1386,1169,3534,960800,0.27702320316921336,0.3921901528013582,0.3307866440294284,5
960900,701,892,765,2358,960900,0.2972858354537744,0.3782866836301951,0.3244274809160305,5
961000,1315,1984,2139,5438,961000,0.24181684442809856,0.3648400147112909,0.3933431408606105,5
961100,1073,1581,1709,4363,961100,0.24593169837267934,0.362365344946138,0.39170295668118266,5
961200,1355,1863,1939,5157,961200,0.2627496606554198,0.3612565445026178,0.3759937948419624,5
961300,1036,1533,1584,4153,961300,0.249458222971346,0.36913074885624847,0.38141102817240546,5
961400,921,1100,1128,3149,961400,0.2924738012067323,0.3493172435693871,0.3582089552238806,5
961500,485,643,745,1873,961500,0.2589428723972237,0.3432995194874533,0.397757608115323,5
961600,766,940,931,2637,961600,0.29048160788775124,0.35646568069776263,0.35305271141448613,5
961700,797,1086,975,2858,961700,0.2788663400979706,0.3799860041987404,0.34114765570328903,5
961800,951,1190,1265,3406,961800,0.2792131532589548,0.34938344098649443,0.3714034057545508,5
961900,401,538,469,1408,961900,0.28480113636363635,0.3821022727272727,0.3330965909090909,5
962000,381,539,569,1489,962000,0.2558764271323036,0.36198791134989927,0.38213566151779715,5
962100,278,400,486,1164,962100,0.23883161512027493,0.3436426116838488,0.4175257731958763,5
962200,612,798,800,2210,962200,0.27692307692307694,0.3610859728506787,0.36199095022624433,5
962300,749,844,1988,3581,962300,0.20915945266685285,0.23568835520804243,0.5551521921251047,6
962400,352,413,584,1349,962400,0.2609340252038547,0.3061527057079318,0.4329132690882135,5
962500,291,377,418,1086,962500,0.26795580110497236,0.34714548802946593,0.3848987108655617,5
962600,223,334,476,1033,962600,0.2158760890609874,0.3233301064859632,0.46079380445304935,5
962700,393,465,665,1523,962700,0.25804333552199604,0.30531845042678923,0.4366382140512147,5
962800,372,524,819,1715,962800,0.21690962099125363,0.30553935860058307,0.4775510204081633,5
962900,291,378,676,1345,962900,0.21635687732342007,0.2810408921933085,0.5026022304832714,6
963000,438,573,864,1875,963000,0.2336,0.3056,0.4608,5
970100,2093,3077,2846,8016,970100,0.2611027944111776,0.3838572854291417,0.35503992015968067,5
970200,2132,3148,3180,8460,970200,0.2520094562647754,0.37210401891252953,0.375886524822695,5
970300,1683,2558,2753,6994,970300,0.2406348298541607,0.365742064626823,0.3936231055190163,5
970400,1790,2626,2701,7117,970400,0.25151046789377546,0.3689756920050583,0.37951384010116623,5
970500,2408,3631,3426,9465,970500,0.25441098784997357,0.38362387744321186,0.3619651347068146,5
970600,2240,3383,3115,8738,970600,0.25635156786449986,0.38715953307393,0.35648889906157016,5
970601,418,669,658,1745,970601,0.23954154727793697,0.3833810888252149,0.37707736389684815,5
970602,368,596,576,1540,970602,0.23896103896103896,0.38701298701298703,0.37402597402597404,5
970700,1743,2355,2308,6406,970700,0.2720886668748049,0.36762410240399623,0.3602872307211989,5
970800,1189,1693,1435,4317,970800,0.27542274727820243,0.3921704887653463,0.33240676395645125,5
970801,406,533,639,1578,970801,0.2572877059569075,0.3377693282636248,0.4049429657794677,5
970802,406,576,729,1711,970802,0.23728813559322035,0.33664523670368207,0.4260666277030976,5
970900,1660,2420,2151,6231,970900,0.26640988605360294,0.38838067725886694,0.34520943668753007,5
971000,2061,2805,3107,7973,971000,0.25849742882227517,0.35181236673773986,0.3896902044399849,5
971100,1337,1985,1793,5115,971100,0.2613880742913001,0.38807429130009774,0.35053763440860214,5
971200,1184,1715,1768,4667,971200,0.2536961645596743,0.3674737518748661,0.3788300835654596,5
971300,781,1079,954,2814,971300,0.2775408670931059,0.3834399431414357,0.3390191897654584,5
971400,708,916,1027,2651,971400,0.26706903055450776,0.34552998868351564,0.3874009807619766,5
971500,545,706,901,2152,971500,0.25325278810408924,0.32806691449814124,0.4186802973977695,5
980000,24,30,29,83,980000,0.2891566265060241,0.3614457831325301,0.3493975903614458,5
980002,14,11,8,33,980002,0.42424242424242425,0.3333333333333333,0.24242424242424243,1
980003,10,12,4,26,980003,0.38461538461538464,0.46153846153846156,0.15384615384615385,1
980100,94,112,252,458,980100,0.2052401746724891,0.2445414847161572,0.5502183406113537,6
981000,123,134,330,587,981000,0.20954003407155025,0.2282793867120954,0.5621805792163543,6
981100,80,87,187,354,981100,0.22598870056497175,0.2457627118644068,0.5282485875706214,6
982000,98,95,223,416,982000,0.23557692307692307,0.2283653846153846,0.5360576923076923,6
982100,84,107,216,407,982100,0.20638820638820637,0.2628992628992629,0.5307125307125307,6
983000,61,100,197,358,983000,0.17039106145251395,0.27932960893854747,0.5502793296089385,6
984000,50,65,125,240,984000,0.20833333333333334,0.2708333333333333,0.5208333333333334,6
985000,93,95,380,568,985000,0.1637323943661972,0.16725352112676056,0.6690140845070423,6
990000,103,109,96,308,990000,0.3344155844155844,0.3538961038961039,0.3116883116883117,3
990001,8,11,17,36,990001,0.2222222222222222,0.3055555555555556,0.4722222222222222,5
990100,203,219,210,632,990100,0.3212025316455696,0.34651898734177217,0.3322784810126582,3
990200,32,63,43,138,990200,0.2318840579710145,0.45652173913043476,0.3115942028985507,5
990301,25,28,27,80,990301,0.3125,0.35,0.3375,3
990302,29,28,21,78,990302,0.3717948717948718,0.358974358974359,0.2692307692307692,1
990400,24,26,46,96,990400,0.25,0.2708333333333333,0.4791666666666667,6
